                                                                                                                                                 
                                                                                                                                                 
                                         @####@.                                                                                                 
                                       @########@                                                                                                
                                     .###########                                                                                        @%##@@# 
                                    :############                                                                                       %####@###
                                    %############                                                                                     .######%###
                                   *#############.                                                                                    %##########
                                   ##############+=                                                                                   %#####%####
                                   @#############*%*@                                                                                 %#####@####
                                   @#######%#####%==%=@                                                                               %#####@####
                                   @#######%#####@===@@                                                                               %#####@####
                                   @#######%##@    @@=%=@.                                                                            %#####%####
                                   @######@@          @@=@                                                                           @=@#########
      .@=@#                        @###@.                @@                                                                         @     @%#####
      @=+=+                        @@                       @@.                                                                   =@         @%##
     @+@=+#=.                      %.@@                        =@-                                                               @.             %
    @#=@+==*@                      @.   @@                        .@%                       #%*                                 @                
  @==@==@*=@=@                     @.      @@                         @@                 :%#@###%=                            @@                 
 ==#=@+   .@@=@                      @@      .@*                         @@             @###@#####@                          @                  @
@+@+         .@@                        %@.     .@=                         @@         #####@######                        .@                 .@+
=                @@                        #@.     =@.                         %@.    @#####@######                       @+                 @#++
                    @@          .             +@::@@                              =@=@######@######                      @                  @++++
                       @@@#@==@@===%=@ ==     @@:                                    %######@######   @-               -@                 @%+++++
                          @@==+=*==@@=@#=*=@@                                        %######@###### .=##@             @.                 @+++++++
                             +@+==+%=#+=@@                        -@                 #######%######@@=*==@+          @                 @@++++++++
                                :@#%@@:                        %@*+#+@@              ##############@@:  @@-        @@                 @++++++++++
                                                            @@+++++*++++@@           ###########%@         =@+    @                 @@+++++++++++
                                                         @@++++++@@@+++++++@@.       ########@+               .@@@                 @+++++++++++++
                                                     .@@++++++@@     %@*++++++#@+    #####@.                      @              #@+++++++++++++@
                                                  =@#++++++@@           :@@++++++*@@ #%@                             =          @++++++++++++@@  
                                                 @@+++++@@                  @@+++++@@                                   .:    +@++++++++++@@     
                                                    @@@                        @@%                                           @%+++@@**#@@        
                                                       @@                       @+@@.                                          :@@#=*=#          
                                                          %@.+@@=#@@            @++++%@:                                           @@*#          
@                                                            +@+=*%@            @@++++++#@=                                          :@          
++@@.                                                           -@*@               @@++++++*@#                                    #@*+@          
+++++%@-                                                         @@@                  @@+++++++@@                              @@+++++@          
@@++++++*@@                                                   @@+++@                     @@+++++++@@                        @@+++++++*@          
   @@+++++++@@                                            :@@++++++@                        %@*++++++@@                  @@+++++++@@.            
      *@#++++++@@.                                     @@*+++++*@@                             +@*++++++@@           .@@+++++++@@                
         .@@++++++%@-                               * @@++++@@:                                   -@#++++++@@     -@#+++++++@@                   
             @@*+++++*@@                        #      .@@@                                          .@%++++++@@@*++++++*@%                      
                -@@++++++@@                 .            @                                              .@@++++*+++++@@:                         
