                                                                                                                                                 
                                                                                                                                                 
                                                                                                                                                 
                                              @%#@@                                                                                              
                                           #########@                                                                                            
                                          @##########                                                                                         @@@
                                         @###########.                                                                                      @####
                                        @######%#####:                                                                                     @#####
                                       .#######%#####*                                                                                    @######
                                       .#######%#####%=.                                                                                  @######
                                       -#######@#####@=+*                                                                                 @#####%
                                       =#######@#####@+%=#@                                                                               @#####@
                                       +#######@#####@@=+=@                                                                               @#####@
                                       *#######@###@  @@=#==%                                                                             @#####@
                                       @#######@@        @@==@                                                                            @@####%
           .@@                         @####@.              -@+                                                                         @@   .@##
          #====-                       @%@                     .@@                                                                     @        .
         @==++=*:                      -%@.                        @@                                                                .@          
        @=##==+=.                      -+  #@.                        @@                                                            @-           
       @==%=*=*=#+                     -=     @@                         @@.                  @#@###@                              @             
      @*=#@:  @@==@                     .@#      @@                         %@:             @###@#####@                          *@              
    :=#@.        @@.                       .@@      @@                         -@#         @####@######                         @.               
   #@.              @@.                        @@      @@                         .@@     @#####@######.                       @                 
%@.                    =@=                        @@  -@%                             @@ .######%######.                     @@                 @
                          :@#@@+#@-:#%+@#%         @@.                                   @######%######.                    @                  @+
                             .@@=%=%==@+%=+@=@@+@@                                       @#############. @==@             .@                 @%++
                                .@@#=%=@==%=+@%                                          @#############@====@@           @=                 @++++
                                    @@=+=@@.                        @@+@@@.              @#############=@@.=@#@         @                 @@+++++
                                       @                         @@++++%+++#@+           @###########%@.       @@     =@                 @+++++++
                                                             .@@++++++@#+++++++@@        @########@-              @@.@.                @@++++++++
                                                          :@@++++++@@   .@@+++++++@@     @#####@                                      @++++++++++
                                                       *@*++++++@@          @@+++++++@@  @#%@                           .-.         #@+++++++++++
                                                     @*++++++@@                @@*++++++@@                                  @      @++++++++++*@+
                                                       :@#@@                      -@%@*                                        -.=@+++%+@@=*@+   
                                                          .@%                       @+@@                                           @@@==%=+      
@                                                             @@ @=+@@#@            @++++@@                                           @@+@*      
++@@:                                                            @@==@=@            @*++++++@@                                           -@.     
+++++*@%                                                            @@=@              -@#++++++@@                                      @@+@:     
@@+++++++@@                                                           @@                 .@%++++++@@                                @@++++@.     
   @@+++++++@@                                                    .@@++@                    .@@++++++@@.                         @@+++++++@      
      #@#++++++@@.                                             +@#+++++@                       .@@++++++%@:                  .@@+++++++@@.       
         .@@++++++*@#                                       @@++++++*@@                            @@++++++#@=            :@%+++++++@@           
             @@+++++++@@                                 =@*+++++@@.                                  @@++++++*@#      *@*+++++++@@              
                -@@++++++@@                          %     *@*@@                                         @@+++++++@@@@+++++++#@+                 
