                                   @@##@%                                                                                                        
                                 @##@#####-                                                                                                      
                               .%###@#####@                                                                                        %@%%@@        
                              -#####%#####@                                                                                       %####%##%. *@@ 
                              #############                                                                                      ###########@%%=@
                             @#############                                                                                     #############=%==
                             @#############=#                                                                                   ######@######@@==
                             @#############=#=@                                                                                 ######@#######:#@
                             @#############+=@==.                                                                               ######@#######@  
                             @#############+*=*=#                                                                               ######%#######@  
                             @##########@+  @@=%==:                                                                             ##############@  
                             @#######@         @@==@                                                                           @@@############:  
 @@@                         @###@%               *@:                                                                         @    =@@########.  
@=*=#                        @@.                     :@*                                                                    :@        :@######.  
=@@#=%                       @@@.                       .@@                                                                @:            .@###   
#=@++@                       @   @@                         @@                                                            @                 .@.  
+=@=#==@                     @      @@                         @@                   @#@###@                             #@                 .@#+%@
@   @@==@                     :@+      @@                         @@.             @###@#####-                          @.                 @#+@+++
       @@                        .@#      @@                         +@-         #####@#####@                        .@                 .@+++@@@+
          @@                        .@%      @@                         .@#     @#####@#####@                       @#                 @%++++@  .
             %@.                       .@@  @@                             .@@ @######@#####@                      @                  @++++++@   
                =@-@@@+@.@==+@=.        .@@                                   .#######@#####@   .                .@                 @@+++++++@   
                   .@%=#=#==**+=@==@@%@:                                      .#######@#####@ .=#=@             @-                 @+++++++++@   
                       @@==#=#=@*=@@                                          .#######@#####@@%=%=@-           @                 @@++++++++++@   
                          @@=*=@@                        .@@++@@.             .#######@#####@=@@ #@+.        +@                 @++++++++++++@   
                             :                        =@#+++*++++%@-          .#######@####@.       .@@     @.                #@+++++++++++++@   
                                                   @@*+++++*@*++++++*@%       .#######%#@               @@.@                 @+++++++++++++++@   
                                                @@++++++*@=   :@@+++++++@@    .#####@*                     .               +@+++++++++++++@@     
                                             @@++++++*@=         .@@+++++++@@ .##@.                           ...         @++++++++++++@@        
                                          .@*+++++#@-                @@++++++@@.                                  @     -@++++++++++@@           
                                             +@#@:                      =@@@                                         + @*+++@*@=@@@              
                                                -@+                       @*@#                                           @@@====@                
                                                   .@@.@-@@@@@            @++++@@                                           @@==@                
                                                      .@@==@=@            @*++++++@@                                           #@                
                                                          @@=@              *@*++++++@@                                     .@@+@                
@                                                          +@@                 =@#++++++@@                               :@%++++@                
++@@                                                    @@+++@                    :@%++++++@@                         #@*+++++++@                
+++++@@.                                             @@++++++@                       .@@++++++@@.                  @@+++++++*@@                  
@@++++++#@=                                      .@@++++++@@.                           .@@++++++%@:            @@+++++++%@-                     
   @@++++++*@@                                *.@+++++*@@                                   @@++++++*@+      @@+++++++@@.                        
      +@%++++++@@                         .:     @*@@.                                         @@++++++*@%@@+++++++@@                            
          @@++++++@@.                  -          #@                                              @@+++++@++++++@@                               
             @@*+++++#@=            @@@%           .@                                                @@++@++#@+                                  
                :@@+++++*@@      @@++++*@            @                                                  @@@.                                     
