                                                                                                                                                 
                                                                                                                                                 
                                                                                                                                                 
                                               %@@%                                                                                              
                                            .@#%####@                                                                                            
                                           @###%#####%                                                                                         .@
                                          @##########%                                                                                       @###
                                         @############                                                                                      @####
                                        ##############                                                                                     @#####
                                        @#############=@                                                                                   ######
                                        @#############=+%@                                                                                 ######
                                        @#############====@.                                                                               ######
                                        @#############%@*==+                                                                               ######
                                        @###########@@@@+#*==.                                                                             ######
                                        @########@.      %@+=+@                                                                            @#####
             =                          @####%@             -@*                                                                          @@  .@#%
           @====.                       @#@:                   .@@                                                                      @.      .
          @=@+=#@                       @@-                        @@                                                                 .@         
         *=*+%%*=                       @  =@.                        @@                                                             @*          
        @===@@*==+@                     @     #@.                        @@.                   *@@##@-                              @            
       +%==@@ @@==+@                    .@@      @@                         *@-              -###@####@                           :@             
     ===@@       @@@                        @@      @@                         :@#          @####@#####@                         @:              
     @@             %@:                        @@      @@                         .@@      @#####@#####%                        @                
 .@@                   -@+                        @@    @@                            @@  .######@#####%                      %@                 
@                         .@% @ @@=  %@@.@          .@@                                  @@######@#####%                     @.                 @
                             .@@=*=*==@=@=@@=#@*@#@-                                      #######@#####%  @==@             .@                 @@+
                                 @@==%=@@##===@@                                          #######@#####%@+%*+=@           @#                 @+++
                                    @@%=@==@@                        .@@@@:               #######@#####%=%@@@#=@         @                 %@++++
                                       @@=                        -@%++++++*@#            #######%#####@@     .@@      :@                 @++++++
                                                               @@*+++++*+++++++@@         #######%##@.            @@. @-                +@+++++++
                                                            @@++++++#@- .@@+++++++@@     .######@@                   @                 @+++++++++
                                                         @@++++++#@-        @@+++++++@@. .###@.                         .:           -@++++++++++
                                                      @@++++++#@:              @@*++++++%@@                                 @       @*++++++++++@
                                                       .@%+#@:                    :@%+@@                                       -  .@++++++@@+@@  
                                                           @@                        @@@                                           @@@%==*=@     
@                                                             @@  . #- @@            @+++@@                                           @@++*@     
++@@:                                                            @@==@==@            @++++++@@                                           :@@     
+++++*@@                                                            @@==@             :@%++++++@@                                       .@@@     
@@+++++++@@                                                            @@                .@@++++++@@                                 :@%+++@     
   @@+++++++@@.                                                     @@++@                   .@@++++++@@.                          #@*++++++@     
      #@#++++++%@:                                               @@+++++@                       @@++++++#@-                    @@+++++++*@@      
         .@@++++++*@#                                        .@@++++++@@-                          @@++++++*@*              @@+++++++#@=         
             @@*++++++@@                                   @#+++++*@@                                 @@++++++*@@        @@+++++++@@.            
                -@@++++++@@                            =    @++@@:                                       @@+++++++@@ .@@+++++++@@                
