                        @####@#####@                                                                                        @###%@.              
                       @#####@#####@                                                                                      @########%.=@*@        
                      %######@#####@                                                                                     @#####@#####+===@       
                      @######@#####@                                                                                    %######@#####@==@=@      
                      @######@#####@=@                                                                                  %######@######@#@==@     
                      @######@#####@==%%                                                                                %######@####### .@%=@*   
                      @######@#####%@=@#+                                                                               %##############.    @@   
                      %######@#####%=@==+#                                                                              %##############        @@
                      %######@##@@   @@=+=@@                                                                            %#####@########          
                      #######@.         =@+=.                                                                           @.@###@#######%          
                      ###%@                .@%                                                                        %@    .@@#######%          
                      @-                       @@                                                                    @          @#####@          
                      @-@:                        @@                                                               .@              @##@          
                      @   +@.                        @@.                      .##:                                @%                 .@+         
=                     @      %@.                        #@.                 @######@                             @                  @*@+*@=      
+                       @@      @@                         -@=            +##########.                         :@                 .@++@++++*@=   
%@.                        @@      @@                         .@@        @###########@                        @:                 @#+++@@@+++++*@=
   +@-                        @@      @@                          @@    :############@                       @                  @+++++@   @@+++++
      :@*                        @@ @@.                              @@ @######%#####@                     *@                 @%++++++@      @@++
         .@@=@@=@@#====#  @.    .@@                                    @#######@#####@   @                @.                 @++++++++@         @
             @@=%=#===+==+=*#+@*                                       @#######@#####@ @#%=.             @                 @@+++++++++@          
                @@==%==*==@@.                        @.                @#######@#####@====@@@          @@                 @+++++++++++@          
                   @@==@@                         @@+@+%@-             @#######@#####@@@  .@@         @                 @@++++++++++++@          
                                              .@@++++@++++*@@          @#######@###@:         @@    .@                 @++++++++++++++@          
                                           =@#++++++@@%+++++++@@       @#######@@                @@@-                #@++++++++++++++%@        @%
                                        @@*++++++@@     @@+++++++@@    @####%@                      ..              @+++++++++++++@@.          @+
                                     @@+++++++@@           @@+++++++@@.@#@-                             *         =@+++++++++++@@.            .@+
                                   :@%+++++@@                 #@#++++#@+                                   #     @++++++++++@@.                %@
                                      .@@%                       .@@.                                         .-@+++@@@@=@@.                     
                                         .@@                      +#+@@                                           @@=%===@                       
                                             @@@@@#+@=.           @+++++@@                                           #@@=@                       
                                                @@==+=.           .@#++++++@@                                           @@                       
                                                   @@=               .@%++++++@@                                     @@++@                       
                                                   .@@-                 .@@++++++@@.                             .@@+++++@                       
                                                #@*++**                     @@++++++%@:                       :@%+++++++@@                       
=                                            @@++++++*@                        @@++++++#@=                 *@*+++++++@@                          
+*@@                                      @@++++++@@=                             @@++++++*@@           @@+++++++*@%                             
+++++@@                               -. @+++++@@                                    @@+++++++@@     @@+++++++%@-                                
@@++++++@@.                       .+      @@@:                                          @@+++++++@@@+++++++@@.                                   
   @@++++++#@=                 -           @#                                              @@+++++@+++++@@                                       
      =@%+++++*@@           @@+@=           :@                                                @@*+@+*@@                                          
          @@++++++@@     @@+++++#@            @                                                  *@=                                             
             @@*+++++@@@++++++++++@            @                                                                                                 
                .@@+++*++++%@%@++++@            @.                                                                                               
