       %######@#####@@@@:                                                                                @######@######@@@#@#                    
       %######@#####@@===@                                                                               @##############.  @@=*                  
       %######@#####@==+=*                                                                               @##############.     @@.                
       #######@####@+@#@===@                                                                             @#####%########         #@.             
       #######@#@      .@@@@=*                                                                           @#####@########            =@=          
       #####@%             @@                                                                           @.  @##@#######@               .@%       
       ##@.                   @@                                                                       @       @#######@                   @@    
       @@                        @@.                                                                 @@           @%###@                      @@ 
       @ .@@                        *@:                                                             @                @%@                         
       @     @@                        :@#                    @####@                              .@                  @@@@                       
       @@      .@+                        .@@               @########@                           @=                 @@+@+++@@                    
          @@      :@:                         @@           @##########-                         @                  @+++@++++++@@                 
             @@      =@.                         @@       %###########@                       =@                 +@++++@ @@++++++@@       .      
                @@.    @@                           @@.  @############@                      @.                 @++++++@    %@*+++++@@@####@#@   
:  =*@.:@          @@#                                 +@#######%#####@                     @                 -@+++++++@       -@#++*######@###@ 
=@==*====@@=* +@@@.                                     @#######%#####@  @*@              %@                 @+++++++++@          .@@######@####@
@==@=@==*=+=#@@                                         @#######@#####@@=#%=@            @                 .@++++++++++@            @######@#####
  *@+===#+@%                        :@@@@               @#######@#####@=+@@@==.        .@                 @*+++++++++++@            @######@#####
     -@@.                        #@*++@+++@@            @#######@#####@-     @@.      @+                .@+++++++++++++@            @######@#####
                              @@++++++@++++++@@         @#######@#%@            -@%  @                 @*++++++++++++++@         @@.@######@#####
                           @@++++++%@. @@+++++++@@.     @######@*                   @                 @++++++++++++++@@         @@@ @######%#####
                        @@++++++@@.       @@*++++++#@+  @###@.                         @            @%++++++++++++@@            @+++@@###########
                    :@%++++++@@              .@@+++++++@@@                                -        @+++++++++++@@              =@++++++*@@#######
                      @@++@@.                    @@++@@                                       -  @%+++++*@#+@@                    @@+++++++@@####
                         @@                        =@@                                           @@%#@==#=@                          @@+++++++@@#
                            @@     :  @            @*++@@.                                          .@@=%=@                             @@+++++++
                               @@==%===.           @++++++@@.                                           @@@                                *@*+++
                                  %@===              @@++++++#@-                                       :@@@                                   :@@
                                     +@                 @@++++++*@+                                 +@*+++@                                      
                                   @@+%:                   @@++++++*@%                           @@*++++++@                                      
                               .@@++++#*                      @@+++++++@@                     @@+++++++*@*                                       
                            -@%++++++@@.                         @@+++++++@@               @@+++++++@@.                                          
                         :@*+++++*@@                                %@*++++++@@        .@@+++++++@@                                              
                     .-   #@++@@.                                      +@*++++++@@  :@%+++++++@@                                                 
                  @         @                                             :@#++++++@++++++*@@                                                    
              .@@            @                                               .@%+++@+++%@:                                                       
+@@.       .@%+++@            @                                                 .@@@@@                                                           
++++%@= .@@+++++++@            @-                                                                                                                
@@+++++*++++++@@+++@-           *@                                                                                                               
   @@*+*++*@@  @++++#@            @                                                                                                              
      :@@      @++++++@            @                                                                                                             
               @+++++++@            @.                                                                                                           
               @*+++++++@.           @=                                                                                                          
               %*++++++++@@           =@                                              .=*=#                                                      
