                                                                                                                                                 
                                                                                                                                                 
                                                                                                                                                 
                                           .@####%%                                                                                              
                                          @########@                                                                                             
                                        =###########                                                                                        @###@
                                       =############.                                                                                      %####@
                                       %############.                                                                                    .######%
                                      =#############+                                                                                    %#######
                                      +#############*=                                                                                   %#######
                                      @#############%@=@:                                                                                %#####@#
                                      @#######%#####@#==*@                                                                               %#####@#
                                      @#######@#####@=#==@+                                                                              %#####@#
                                      @#######@#%@    @@=*=@@                                                                            %#####%#
                                      @######@*          @@=@                                                                           @.+@#####
         %@==@                        @###@                 +@-                                                                        @     -@##
         @=@=+                        @*                       .@#                                                                   @@         :
        @@*==#*:                      %:%@.                       .@@                                                               @.           
       @==@====@                      @:   @@                         @@                       @@@.                                @             
     @==#=%@@=*=@                     @=      @@                         @@                 *##@####@                            @*              
    @==@@.    @@=@                      :@*      @@                         %@.            @###@#####@                          @                
   @@@.          @@                        .@#      @@                         -@=        #####@######                        :@                 
 %@.                @@                        .@%      @#                         .@%    @#####@######                       @:                 @
                       *@:         -.             @@@@-                               @@@######@######                      @                 .@+
                          -@@=@@=@@===#=@ @@:    @@                                     %######@######   @@               #@                 @*++
                             .@@=@=%==#@=*@+==@@                                        %######%###### .#=#@             @.                .@++++
                                 @@==@#+==@@-                        @@                 %######%######@@=@==@@          @                 @#+++++
                                    @@#@@                         @@++#+@@.             %#############@@   =@#        @#                 @+++++++
                                                               @@+++++*++++#@=          ###########@#         .@@    @                 @%++++++++
                                                           .@@++++++@@@*++++++*@@       ########@.                @@@                 @++++++++++
                                                        +@#++++++@@     .@@+++++++@@    #####@                       =              @@+++++++++++
                                                     @@*++++++@@            @@+++++++@@ #@#                             .:         @+++++++++++*@
                                                    #@*++++@@                  @@*+++*@@                                    @    @@+++++*+++*@-  
                                                       =@@                        -@+                                           @@+++*@=@*@-     
                                                          :@+                      @+*@@                                           @@==*=+       
@                                                            .@%+@@==@@            @+++++@@                                           @@#+       
++@@.                                                           .@@=*#@            %@*++++++@@                                          %@       
+++++#@*                                                            @@@               +@*++++++@@                                    @@++@       
@@+++++++@@                                                         @@@                  -@#++++++@@                              @@+++++@       
   @@+++++++@@                                                  :@@+++@                     .@@++++++@@.                      .@@+++++++@@       
      #@#++++++@@.                                           @@*++++++@                        .@@++++++@@.                :@%+++++++@@          
         .@@++++++#@*                                     @@++++++#@%                              @@++++++%@-          +@*+++++++@@             
             @@*++++++@@                              .. :@++++@@.                                    @@++++++*@+    @@*++++++*@#                
                -@@++++++@@                        #       @@+                                           @@++++++*@@+++++++@@:                   
