           @######@#####@@                                                                                   =######@#######+@==@                
           @######@#####%=@-                                                                                 =######@######@@=@=@                
           @######@#####%+==@:                                                                               =######@#######+ +@+=@              
           @######%######=@@=@                                                                               =##############-    :@%             
           @######%#####@@=%=*@@                                                                             =##############.       .@@          
           @######%##@     @@=*=@@                                                                           =#####%########            @@       
           %#####@*           %@=                                                                           :@ +@##@########               @@    
           %##@                  =@=                                                                       @:     -@#######%                  @@ 
           @.                       .@@                                                                   @          .@####%                     
           @ @@.                        @@                                                              %@              .@#@                     
           @    @@                         @@                      @@@@.                               @.                 @@@.                   
           @=      @@                         @@.                @#######=                            @                  @+@++%@.                
             :@*      @@                         #@:           @##########+                         @#                 @@++@+++++%@.             
                .@#      @@                         -@*       @#####%#####@                        @                  @++++@.@@+++++@@.          
                    @@     .@                          .@@   +######%#####@                      :@                 *@+++++@    @@+++++%@.@#####@
        @:  .          @@@+                                @@@######@#####@                     @-                 @+++++++@       @@++++%#####%#
@#==%=@=+====:@@@  . @@.                                    +#######@#####@  *@@               @                 -@++++++++@          @@#######@#
  .@@=#=#====*=+==@@                                        +#######@#####@.@=#+@            *@                 @++++++++++@            @######@#
     .@@=#%=+=%@+                        +@@                +#######@#####@+=*@%=#@         @.                .@+++++++++++@            @######@#
         @@@@.                        @@++%++@@.            *#######@#####@@.   -@@        @                 @*++++++++++++@            @######@#
                                   @@+++++@+++++#@+         ########@##@@           @@   @@                .@++++++++++++++@          @@@######@#
                                @@++++++@@*@#++++++*@@      @#######@:                 @@                 @*++++++++++++++@@        @@- @######@#
                            :@%++++++@@      .@@+++++++@@   @####@                        -.             @+++++++++++++@%           @++*@@#####@#
                         *@*++++++@@             @@+++++++@@@%@                               -        @#++++++++++*@@              @++++++@@##%#
                         *@*+++@@                   @@*+++@@                                     @    @++++++@+++@@                  @@+++++++@@#
                            =@=                        .@=                                          :@@++@=@=*@#                        *@*++++++
                               :@*        =            :%+*@%                                           @@-*==@                            :@%+++
                                  .@@=#=+=@-           =#+++++@@                                           @@*@                               .@@
                                      @@==+-            #@*++++++@@                                         +@@                                  
                                         @@.               +@*++++++@@                                   @@*++@                                  
                                        @@*%                  :@#++++++@@                             @@++++++@                                  
                                    .@@++++@                     .@%++++++@@.                      @@+++++++%@-                                  
                                 *@#++++++@@                        .@@++++++@@.                @@+++++++@@.                                     
                              @@++++++*@%                               @@++++++#@-         :@%+++++++@@                                         
                          .:  @#+++@@                                      @@++++++*@*   *@*++++++*@@                                            
.                      @       =@@                                            @@++++++*@*++++++#@=                                               
+@@.               =@            @                                               @@++++@++++@@.                                                  
++++*@#         =@*++@            @                                                 @@+@+@@                                                      
@@++++++@@   -@*++++++@            @.                                                  *                                                         
   @@*+++++@#++++++@*++@.           @+                                                                                                           
      :@@++++++#@@ **+++@#           -@                                                                                                          
          @@@@.    +*++++*@            @                                                                                                         
                   =#++++++@            @                                                                                                        
                   =#+++++++@            @.                                                                                                      
