                     %###########.                                                                                      @####@##%.  @@           
                    @############.                                                                                     @#####%####@%==@          
                   -#############.                                                                                    @############=+==@         
                   =#############++.                                                                                  %############@%=+%+        
                   ##############%*=@                                                                                 %#####@#######%@@==@       
                   @#######%#####%#@=+#                                                                               %#####@#######@   +@@      
                   @#######%#####@@=#=@                                                                               %#####@#######@      :@#   
                   @#######@###@  @@=@==:                                                                             %#####@#######@         .@@
                   @#######@%        @@==@                                                                           .@@############@            
                   @####@.              @@.                                                                         @+   +@#########@            
                   @%@                     =@+                                                                     @        =@######%            
                   %@@                        .@@                                                                -@            :@###:            
                   @:  @@                         @@                                                            @.                .@.            
                   @.     @@                         @@                   @#@###@                              @                  @+*@@.         
                    =@-      @@                         @@.             @###@#####@                          %@                 -@+*++++@@.      
                       :@+      @@                         %@:         @####@#####%                         @                  @*++%@#+++++@@.   
@@.                       .@%     .@@                         -@*     @#####@######                       .@                 .@++++@  .@@+++++@@.
   @@.                       .@@  -@*                            .@@ .######@######                      @*                 @*+++++@.     @@+++++
      #@:@@@@@.-*@@@%=         @@.                                   @######@######                     @                 .@+++++++@.        @@++
         -@#=+=*==@#%=%@=@@+@@                                       %######%######  @==@             :@                 @#++++++++@.           @
            .@@+=+=@=*%=+@#                                          %######%######@===+#@           @:                 @++++++++++@.           .
               .@@=#=@@.                        @@+%@@               ##############=@@.@@=@         @                 @%+++++++++++@.           .
                   @                         @@++++*+++@@.           ############%@       :@@     #@                 @+++++++++++++@.           @
                                          @@++++++@*++++++*@+        #########@:              @@ @.                @@++++++++++++++@:        @@ +
                                      :@@++++++@@   =@%+++++++@@     ######@                                      @+++++++++++++*@*         @+%@@
                                   #@*++++++@@         .@@+++++++@@  ##%@                           :..         @@+++++++++++*@+            @++++
                                 @+++++++@@                @@+++++++@@                                  +      @++++++++++*@+               @@+++
                                   %@*@@                      %@#@#                                        # *@+++#+@@**@+                     @@
                                      =@-                       @#@=                                           @@@==%+*                          
                                         :@+ @.@@@@@            @+++*@#                                           @@=#*                          
                                            .@@==#=@            @+++++++@@                                           %@                          
                                               .@@=@              @@*++++++@@                                      @@*@                          
                                                  @@                 *@*++++++@@                                @@++++@                          
                                              .@@++@                    =@#++++++@@                          @@+++++++@                          
                                           +@#+++++@                       :@%++++++@@.                  .@@+++++++@@.                           
:                                       @@++++++*@@                           .@@++++++@@.            :@%+++++++@@                               
+*@@                                 :@++++++@@:                                  @@++++++#@:      #@*++++++*@@                                  
+++++@@                          #     @%*@@                                         @@++++++*@+@@+++++++#@=                                     
@@++++++@@.                  ..         -@                                              @@+++++*++++++@@.                                        
   @@*+++++%@:            *@%@            @                                                @@++*+++@@                                            
      -@%+++++*@%      *@*++++@            @                                                  @@@@                                               
          @@++++++@@+@*++++++++@            @.                                                                                                   
             @@*++++@+++++@@@+++@.           @#                                                                                                  
                .@@+@+@@.   @++++@@           :@                                                                                                 
