  @##############+%==*                                                                               ######@#######@   :@@                       
  @#############@#=+=@                                                                               ######@#######@      .@@                    
  @##########%@  @@=#==:                                                                             ######%#######@          @@                 
  @#######@:        @@==@                                                                           *@@############@             @@              
  @###%@               =@=                                                                         @    :@#########+                @@           
  @@=                     .@@                                                                     @        .@######:                   %@.       
  @+@.                        @@                                                                @@            .@###.                      =@=    
  @.  @@                         @@                                                            @                 .@:                         .@% 
  @      @@                         @@                   @#@###@                             .@                  @++%@.                         .
   .@*      @@                         @@:             @###@#####%                          @-                 @@+#++++%@.                       
      .@%      @@                         -@+         @####@#####@                         @                  @+++@@@+++++%@.                    
          @@      @@                         .@@     @#####@#####%                       +@                 @@++++@   @@+++++%@.  .@@@@.         
             @@  @@.                             @@ +######@######                      @.                 @++++++@      @@+++++%%#####%#@       
++@=:         @@                                    %######@######   .                 @                 +@+++++++@         @@++@##########=     
=#@%=#*=@@+@#                                       #######@######  +==@             @@                 @+++++++++@            %############@    
#=@=%@=@@.                                          #######@######@#=+=@#           @                 -@++++++++++@            .#############@   
@=@=@@                         @@+*@@.              #######%######=@@ *@#%        .@                 @++++++++++++@            :######%#######   
  +                        .@@++++*+++#@=           #######%####@-        @@     @=                :@+++++++++++++@           .@######%#######@  
                        =@#++++++@*++++++*@@        #########@               @@.@                 @*++++++++++++++@.       :@- @######@#######@  
                     @@*++++++@@   .@@+++++++@@     #####%@                                     .@+++++++++++++@@.         @+*@@######@#######%  
                  @@+++++++@@          @@+++++++@@  ##@-                           .:          @*+++++++++++@@.            @+++++@@###@#######=  
                @*++++++@@                @@*+++++#@*                                  %      @++++++++++@@.               @@+++++++@@@#######:  
                  -@#@#                      =@@@.                                        = @#+++@*@*@@@                      *@*++++++#@%####.  
                     :@*                       @*@%                                           @@@==+=@                           :@%+++++++@@#   
                        .@@ @=@@@@@            @++++@@                                           @@++@                              .@@+++++++@@.
                            @@==@=@            @*++++++@@                                           +@                                  @@+++++++
                               @@=@              =@#++++++@@                                      @@+@                                     @@++++
                                .@@                 :@%++++++@@                               .@@++++@                                        %@*
                             *@*++@                    .@@++++++@@.                        :@%+++++++@                                           
                          @@++++++@                       .@@++++++@@.                  *@*+++++++@@                                             
                       @@++++++@@+                           .@@++++++#@-            @@+++++++*@%                                                
                   :.@++++++@@                                   @@++++++*@*      @@+++++++%@-                                                   
                *     @#@@-                                         @@++++++*@%@@+++++++@@.                                                      
            :          -@                                              @@+++++*++++++@@                                                          
         @@#@            @                                                @@++*++*@@                                                             
      @@+++++@            @                                                  @@@=                                                                
+@@@@+++++++++@            @.                                                                                                                    
+++@++++%@@@+++@.           @*                                                                                                                   
@@+@*@@    @++++@@           :@                                                                                                                  
   .       @+++++*@            @                                                                                                                 
           @+++++++@            @                                                                                                                
           @++++++++@            @.                                               .@@.                                                           
           @+++++++++@=           @%                                             @%=#=@                                                          
           @++++++++++#@           :@                                           @=+==+@                                                          
