                           .#########@                                                                                                           
                          @###########                                                                                        @###@#@@           
                         @############                                                                                      :#####@###@@*==      
                         #############.                                                                                    +######%####@+%==.    
                        =#############@.                                                                                   %############@##==@   
                        *##############=%.                                                                                 %#####%#######@@=#@+  
                        @#######%#####@*=*@                                                                                %#####@#######@  @@%# 
                        @#######%#####@+==*@                                                                               %#####@#######@     @@
                        @#######%####@@++==@@.                                                                             %#####@#######@       
                        @#######@#@.    :@%=#+@                                                                            %#####%#######@       
                        @#####%@           .@@@                                                                           @  @###########@       
:                       @##@-                  @@                                                                       :@      @########%       
                        @@                        @@                                                                   @:          @#####=       
*-                      %: @@                        @@.                                                              @               @%#.       
=%#                     @.   .@#                        +@=                     %@@@@                               *@                  @@@      
=**%                    #@      :@-                        .@@                @##@####@                            @.                 @%++++@@   
=@*@                       @@      =@:                         @@           .####@#####@                         .@                  @++*++++++@@
   .@@                        @@      #@.                         @@       :#####@######                        @#                 @@+++@ @@+++++
      .@@                        @@      @@                          @@    @#####@######                       @                  @+++++@    @@++
          @@         @@             @@@@                                @@@######@######                     .@                 @@++++++@.      #
             @@=@=+**@==#=@:@@@   +@+                                     %######@######   @@.              @-                 @++++++++@.       
                @@==*=#=#%@=+#=@@.                                        %######%###### @#==@             @                 #@+++++++++@.       
                   @@===%#==@@                         @@#                %######%#######@=@@==@         +@                 @+++++++++++@.       
                      *@%@+                        :@%++*++@@             ##############@*    @@        @.                +@++++++++++++@.       
                                                #@*+++++*+++++@@          ###########@.          %@-   @                 @++++++++++++++@:       
                                             @@++++++*@=@@+++++++@@.      #######@@                 .@%                :@++++++++++++++@@.       
                                          @@++++++#@-      @@+++++++%@:   ####@:                        *             @*++++++++++++@@           
                                      .@@++++++#@:            =@%++++++*@##@                               #        .@+++++++++++@@              
                                       @@+++%@:                  .@@+++@@.                                    ..   @*+++++@*++@@                 
                                          @@                         @@                                           @@*++=+==@@                    
                                             @@        ..            @++@@                                           =@@@*=*                     
                                                @@=*%===@            @+++++@@.                                          .@@*                     
                                                   @@=+=@             @@++++++@@.                                         @@                     
                                                      @@@                @@++++++#@-                                  .@@++@                     
                                                     @@*@                   @@++++++*@*                            +@#+++++@                     
*                                                 @@++++@                      @@++++++*@@                      @@*+++++++@@                     
++@@                                          .@@++++++%@                         @@+++++++@@                @@+++++++#@*                        
+++++@@                                    =@#++++++@@                               @@*++++++@@          @@+++++++@@.                           
@@++++++@@.                             %   @+++@@=                                     %@*++++++@@   .@@+++++++@@                               
   @@++++++#@#                      +        @@                                            +@*++++++@%+++++++@@                                  
      =@%++++++@@                @            @.                                              -@#++++++++*@#                                     
          @@++++++@@          @@++@            @*                                                .@%++@@.                                        
             @@*+++++@@.   @@++++++@+           :@                                                  .                                            
                .@@+++++*@++++++*@++*@            @                                                                                              
