         %######@#####@=@                                                                                  @######@######%%==@*                  
         %######@#####@=+=-                                                                                @######%######@ @@=*%.                
         %######@#####@==@=@                                                                               @##############.   %@.                
         #######@#####@===@#.                                                                              @#####%########       =@=             
         #######@###@. .@@=@=@.                                                                            @#####@########          .@%          
         #######@#         @@=+                                                                            @@%###@#######%              @@       
         ####@.               @@                                                                         -@    @%@#######@                 @@    
         %@                      %@:                                                                    @.        #@#####@                    @@ 
         @@@                        -@+                                                                @             +@##@                       
         @   @@                        .@@                                                           @@                 -@                       
         @      @@                         @@                  @######@                             @                  @%@+@@                    
          @@.      @@                         @@             :#########@                           @                  @++@++++@@                 
             #@.     .@%                         @@.        @###########@                        @#                 @@+++@@*+++++@@              
                =@-     .@=                         *@:    :############@                       @                  @+++++@  -@#+++++@@   @@%%@   
                   :@= =@*                             :@# @############@                     :@                 @@++++++@     .@@+++++@#####@##@
@#=@:@==##@  .      @@.                                   @#######%#####@   =                @:                 @++++++++@        .@@+%######@###
@%=+=*==%@==@==@=@@                                       @#######%#####@ @=*=              @                 %@+++++++++@            @######@###
  -@#==+===*=*@#                        -                 @#######@#####@====@@:          #@                 @+++++++++++@            @######@###
     .@@==@@.                        @@+@+@@              @#######@#####@@@. @@@         @                 =@++++++++++++@            @######@###
                                  @@++++@++++@@.          @#######@###%@        -@#     @                 @++++++++++++++@           @@######@###
                               @@++++++@@+++++++%@-       @#######@@:               @@@%                :@++++++++++++++*@        @@  @######%###
                           :@%++++++@@    *@*++++++*@@    @#####@.                     @               @+++++++++++++*@*          @+%@%######%###
                        *@*++++++@@          .@@+++++++@@ @#%@                            - .        .@+++++++++++*@*            :@++++*@@#######
                      @@++++++@@                 @@++++++@@                                   =     @*+++++++++*@*                @@+++++++@@####
                         @@@@                       @@@*                                         #.@+++@@@@=@@+                      @@+++++++@@#
                            @@.                      #*%@.                                          .@@@===+@                           @@*++++++
                               *@:@@:*@@=.           @++++#@-                                           @@=+@                              =@#+++
                                  -@*==%=.           @@++++++*@#                                           @@                                 .@@
                                     .@#=               @@++++++*@@                                     @@*+@                                    
                                       @@.                 @@*++++++@@                               @@+++++@                                    
                                   .@@++%:                    #@*++++++@@                         @@+++++++%@                                    
                                +@#+++++*%                       +@*++++++@@                   @@+++++++@@.                                      
                             @@++++++*@@                            -@#++++++@@.           :@%+++++++@@                                          
                          = @+++++@@.                                  .@%++++++@@.     *@*++++++*@@                                             
                      %      @*@@                                         .@@++++++%@@@+++++++#@+                                                
                  ..          @.                                              @@+++++@+++++@@.                                                   
+@@.           *@*@            @*                                                @@++@++@@                                                       
++++#@*     +@*++++@=           :@                                                  @@@                                                          
@@++++++@@@*++++++++*@            @                                                                                                              
   @@*+++*++++*@@@++++@            @                                                                                                             
      :@@#+@@.   @+++++@            @.                                                                                                           
                 @++++++@:           @#                                                                                                          
                 @+++++++%@           :@                                                                                                         
                 @*++++++++@            @                                                @#@                                                     
