                @######@#####@                                                                                     @#####@####%%==+@             
                #######@#####@                                                                                    @######@#####@==*@-            
                #######@#####@=%                                                                                  @######%######@*#=%.           
                #######@#####@=@=.                                                                                @#############@ @@=@=          
                #######@#####@==#%@                                                                               @##############    @@          
                #######@#####@#==%@                                                                               @#####@#######%       @@.      
               .#######@###@  :@#=+=@                                                                             @#####@#######@          #@:   
               .#######@%        .@@=@                                                                            @@####@#######@             =@+
               :####@.               @@                                                                         @@    @#@#######@                
               :@@                      @@                                                                     @         @######@                
                @@@                        @@.                                                                @             @%##@                
                @   @@                        +@-                                                           @*                 %@                
                @     .@*                        .@%                  @#@###%=                             @                  @*@+@@             
                 @@      :@-                         @@             *###%#####@                          :@                 .@++#++++@@          
                    @@      =@:                         @@         @###########=                        @:                 @#+++@@++++++@@       
                       @@.     %@.                         @@     @#############                       @                  @+++++@  @@++++++@@   @
@@                        @@. +@*                             %@. %############%                     %@                 @%++++++@     *@*+++++@##
   @@+@==*@-@+=@*@         @@.                                   @#############%   .                @.                 @++++++++@        -@#+@###
      @@%*=*==+%@==@==@=@@                                       @#############% @==%              @                 @@+++++++++@           .@###
         @@+=*====*=*@*                        .                 @#############@====*@           @%                 @+++++++++++@            @###
            *@+==@@.                        @@+@*@@              @#######%#####@@@. @@@         @                 @@++++++++++++@            @###
               :                         @@++++@++++@@           @#######@###@@        @@.    .@                 @++++++++++++++@           @@###
                                     .@@++++++@@+++++++@@        @#######@@:              :@@@-                *@++++++++++++++*@        @@  ####
                                  -@%++++++@@    @@+++++++@@:    @#####@                      =               @+++++++++++++*@=         .@+@@####
                               @@*++++++@@          #@#++++++*@# @#@@                            % .        =@+++++++++++*@+            %*++++@@#
                             @@++++++@@                .@@++++++@@                                  :.     @++++++++++*@=               .@@++++++
                                @@@@                       @@@+                                         -:@+++@%@@=#@=                      @@+++
                                   @@                       @+@@                                           #@@#===%:                           @@
                                      @@ @@.%@@+            @++++@@                                           .@@+%:                             
                                         @@==+++            @@++++++@@.                                           @@                             
                                            #@=*               @@++++++#@-                                     @@++@                             
                                              @@                  @@++++++*@*                               @@++++*%                             
                                          .@@++@.                    @@++++++*@@                         @@+++++++@-                             
                                       #@#+++++@.                       @@+++++++@@                  .@@+++++++@@                                
                                    @@++++++*@@                            @@+++++++@@            -@#+++++++@@                                   
.                               .=-@+++++@@.                                  %@*++++++@@      @@*++++++*@@                                      
+#@+                         @      @*@@                                         =@*++++++@@@@+++++++#@-                                         
++++*@@                  ..          @                                              :@#+++++@+++++@@.                                            
@@++++++@@            %@+@            @.                                               .@@++@++@@                                                
   @@*+++++@@.     *@*++++@.           @*                                                 .@@@                                                   
      -@@+++++#@#@*++++++++@*           :@                                                                                                       
          @@++++@++++*@@@+++*@            @                                                                                                      
             @@#@+@@.   @+++++@            @                                                                                                     
                .       @++++++@            @.                                                                                                   
