                                                                                                                                                 
                                    :@#####@                                                                                                     
                                   @########@                                                                                                    
                                 @###########                                                                                        @###@#@:    
                                %############.                                                                                     .#####@###@@@=
                                %############.                                                                                    :######%####@+#
                               -#############@                                                                                    %############@%
                               +##############=:                                                                                  %############%@
                               @#######%#####@%=@#                                                                                %#####@#######@
                               @#######%#####@%==@@                                                                               %#####@#######@
                               @#######@####%@=@==%@.                                                                             %#####@#######@
                               @#######@#@@    @@===%@                                                                            %#####%#######@
                               @######@.          -@#@                                                                           @ .@###########@
  @#==@                        @##%@                 .@@                                                                        @     .@########@
 .@#*%*                        @=                        @@                                                                   @@          @#####+
 @@====@-                      %-:@-                        @@                                                               @               @##:
@==%+===@:                     @:   +@.                        @@                      :@@@+                               :@                  @@
==+@@@===@:                    @@      %@.                        #@:                @##@####@                            @-                 @@++
@@     @@=@                       @@      @@                         :@*            %###@#####@                          @                  @++*+
          %@:                        @@      @@                         .@@       .#####@######                        #@                 #@+++@ 
             -@=                        @@      @@                          @@    @#####@######                       @.                 @+++++@ 
                .@%         @-             @@@@                                @@@######@######                      @                 =@++++++@.
                   .@@=@#=@%*==#=@ @@*    @@                                     %######@######   @@               @@                 @++++++++@.
                       @@=*=+==#%+=#@=#@+                                        %######%###### =@==@             @                 :@+++++++++@.
                          @@==*#%==@@.                        @@.                %######%######@@=@*=*@         .@                 @*++++++++++@.
                             @@#@@                        .@@++#+#@*             %#############@@   .@@        @-                .@++++++++++++@.
                                                       .@@+++++*+++++@@          %##########@.          @@.   @                 @*+++++++++++++%:
                                                    +@*++++++@@@@+++++++@@       ########@                 +@@                .@++++++++++++++@@.
                                                 @@+++++++@@      @@+++++++@@.   ####@%                       ..             @#++++++++++++@@.   
                                              @@+++++++@@            @@*++++++@@:#@:                              %         @+++++++++++@@.      
                                             .@%++++@@                  -@%+++%@-                                    =    @%+++++%+++@@.         
                                                .@@                        .@@                                           @@+++=%=+@@.            
                                                    @@                      @++@@                                           @@+#*=+              
                                                       @@+@@==%@            @+++++@@                                           =@@+              
                                                          @@=+=@            :@%++++++@@                                          @@.             
@                                                            @@@               .@@++++++@@                                    @@++@.             
++@@                                                        :@@@                  .@@++++++@@.                            .@@+++++@              
+++++@@.                                                 @@*+++@                      @@++++++#@-                      -@%+++++++@@              
@@++++++#@*                                           @@++++++*@                         @@++++++*@*                #@*+++++++@@                 
   @@+++++++@@                                    .@@++++++@@.                              @@++++++*@@          @@+++++++*@#                    
      +@#++++++@@                              +  .@+++*@@                                     @@+++++++@@    @@+++++++@@:                       
         .@@++++++@@.                      .:       @@.                                           @@+++++++@@+++++++@@                           
             @@*+++++#@#                @            @                                               %@*+++++++++@@                              
                :@@++++++@@          @@++@            @-                                                #@*++*@@                                 
