             ##############.                                                                                    @###########%=#=%                
             @#############=@                                                                                   ######%######@@=@=#              
             @#############=+#@                                                                                 ######@#######:@#=%@             
             @#############+===%.                                                                               ######@#######@  .@@@            
             @#############@%+==*                                                                               ######@#######@      @@          
             @###########@%@@+**==.                                                                             ######%#######@         @@       
             @########@.      +@+=*@                                                                            @#############%            @@.   
             @####%@             :@#                                                                          %@  .@##########*               %@:
             @#@.                   .@@                                                                      @.      .@#######:                  
             @@+                        @@                                                                 .@            @####.                  
             @  :@-                        @@                                                             @*                @#                   
             @     +@.                        @@.                   #@@##@=                              @                  @#*@#                
              @@      %@.                        =@=              -###@####%                           :@                  @+*+++*@*             
                 @@      @@                         .@@          @####@#####@                         @:                 @#++@@+++++*@+          
                    @@      @@                          @@      @#####@#####%                        @                  @++++@  @@+++++*@*    .:#
                       @@    @@                            @@  .######@#####%                      #@                 @%+++++@     @@+++++*@@####
@@ @.@@*  @%@.@          .@@                                  @@######@#####%                     @.                 @+++++++@        @@+++@#####
   @@=#=#==%=@=%@=*@#@%@-                                      #######@#####%  @==@             .@                 @@++++++++@           %@######
      @@==%=@@#%+==@@                                          #######@#####%@+@*+=@           @#                 @++++++++++@            .######
         @@#=@==@@                        .@@%@-               #######%#####%=%@@@%=@         @                 @@+++++++++++@            :######
            @@-                        =@#++++++*@@            #######%#####@%      @@      :@                 @+++++++++++++@            #######
                                    @@*+++++++++++++@@         ##########@.            @@. @:                +@++++++++++++++@.        @@.%######
                                 @@++++++#@- .@@+++++++@@     .######@%                   #                 @++++++++++++++@@         @+@@@######
                              @@++++++#@-        @@+++++++@@. .###@.                          -           -@++++++++++++@@            @++++@@####
                           @@++++++#@:              @@*++++++%@@                                 @       @+++++++++++@@               @*++++++@@#
                            .@@+%@:                    .@@+@@                                       :. .@+++++*@@+@@                    -@%++++++
                                @@                        @@@                                           @@@%==*+@                           @@+++
                                   @@  : %= @@            @+++@@                                           @@#=#@                              @@
                                      @@==@==@            @++++++@@                                           .@@                                
                                         @@==@             .@%++++++@@                                       .@@@                                
                                            @@                .@@++++++@@.                                :@%+++@                                
                                         @@++@                    @@++++++%@:                          %@*++++++@                                
                                      @@+++++@                       @@++++++#@=                    @@+++++++*@@                                 
                                  .@@++++++@@:                          @@++++++*@%              @@+++++++%@-                                    
                                @#+++++*@@                                 @@+++++++@@        @@+++++++@@                                        
.                          .=    @++@@.                                       @@+++++++@@ .@@+++++++@@                                           
+%@-                    %         @.                                             @@++++++*+++++++@@                                              
++++*@@              @@.           %@                                               #@*++*+++#@+                                                 
@@++++++@@        @@+++@#           .@                                                 +@#@@.                                                    
   @@*+++++@@. @@+++++++*@            @                                                                                                          
      -@@+++++@+++++%@@+++@            @                                                                                                         
          @@++@+*@@   @++++@            @:                                                                                                       
             #@.      @+++++@-           #@                                                                                                      
                      @++++++#@           .@                                                                                                     
