                                                                                                                                                 
                                        %@@@                                                                                                     
                                      @#######:                                                                                                  
                                    @##########                                                                                         .@%#     
                                   @###########.                                                                                      @####@##@  
                                  @############.                                                                                     @#####@####@
                                 .#######%#####=                                                                                    @######%#####
                                 :#######%######@.                                                                                  @############
                                 -#######%#####@#+@                                                                                 @############
                                 +#######@#####@*==@@                                                                               @#####@######
                                 *#######@#####@==+=@                                                                               @#####@######
                                 *#######@###%@=@*=%==#                                                                             @#####@######
                                 @#######@@:      .@@=@%                                                                            @#####%######
      :.                         @#####@              @@                                                                          .@   @#########
    @====@                       @#@+                    @@                                                                      @-       @######
   @=====@                       =@@                        @@.                                                                 @            @###
  .+#+#++=-                      =+ .@#                        @@.                                                            +@                @
 @*==@====@@                     =-    .@+                        -@*                   :@@##%@                              @.                 @
@@==@@ *@+=@@                     @@      -@-                        .@@              .@##@#####:                           @                  @+
=@@       -@@                        @@      +@.                         @@          @####@#####%                         @@                 %@++
             .@@                        @@      %@.                         @@      %#####@######.                       @                  @++++
                 @@                        @@    @@.                           @@.  ######@######.                     .@                 +@+++++
                    @@ @.@@*  @*@:@-          @@                                  #@######%######.                    @=                 @+++++++
                       @@=@=@+=*=+=@@=%@-@#@#                                      @#############. @==@              @                 :@++++++++
                          @@=#@=%+@*=+=@@.                                         @#############@*@+*=@           =@                 @*+++++++++
                             @@==+==@@                         @@@@%               @#############=+@@@@=@         @.                .@+++++++++++
                                +@#                        .@@+++%+++@@            @############@@      @@.      @                 @*++++++++++++
                                                        =@#++++++*++++++@@         @#########@             +@+ @@                .@++++++++++++++
                                                     @@*+++++*@%  @@+++++++@@.     @#####%@                   ..                @#+++++++++++++@@
                                                  @@++++++*@#        @@*++++++%@-  %##@-                          @            @++++++++++++@@   
                                               @@++++++*@#              :@%++++++*@@.                                =       @%++++++++++@@      
                                                 @@+*@*                    .@@+@@.                                      .:  @+++++*@@+@@.        
                                                    @@                        @@@                                           @@@%==%**            
                                                       @@  + :* -@            @+++@@                                           :@@=%=            
                                                          @@%=%==@            @++++++@@.                                           @@            
@                                                            @@==@              @@++++++%@:                                       @@@:           
++@@.                                                           @@                 @@++++++#@=                                .@@+++@            
+++++%@:                                                     %@*+@                    @@++++++*@#                          :@%++++++@            
@@++++++*@%                                               @@+++++@                       @@++++++*@@                    *@*+++++++@@             
   @@+++++++@@                                         @@++++++%@#                          @@+++++++@@              @@+++++++*@%                
      *@#++++++@@                                   @@++++++@@                                 @@*++++++@@        @@+++++++%@-                   
         .@@++++++@@:                           %    @*+%@+                                       #@*++++++@@  @@+++++++@@.                      
             @@*+++++*@@                    +.        @@                                             +@*++++++*++++++@@                          
                :@@++++++@@              @@*           .@                                               :@#+++*++*@@                             
