 @#######%#####%#==*@                                                                               %#####@#######@    -@*                       
 @#######%#####@=#==@+                                                                              %#####@#######@       .@@                    
 @#######%#%@    @@=#=@@                                                                            %#####%#######@           @@                 
 @######@+          @@=@                                                                           @.*@###########@              @@              
 @###@                 *@:                                                                        @     =@#########                 @@           
 @*                       :@#                                                                   @@         :@#####=                    @@.       
 @:@@.                       .@@                                                               @              .@##.                       *@-    
 @.   @@                         @@                       @@@.                               .@                  @@.                         :@# 
 @-      @@                         @@                 *##@####@                            @*                 +@+*+@@.                         .
   -@+      @@                         %@.            @###@#####@                          @                  @++*+++++@@.                       
      :@*      @@                         =@-        #####@######                        -@                 -@+++@.@%+++++@@.                    
         .@#      @*                         .@%    @#####@######                       @:                 @+++++@   .@@+++++@@  @####@.         
             @@@@:                               @@@######@######                      @                 .@++++++@.      @@++++@######%##@       
=#=@ @@.    @@                                     %######@######   @@               @@                 @*+++++++@.         @@+@##########@      
=#@=*@*==@@                                        %######%###### .#=%@             @.                .@+++++++++@.            ############@     
@#+==@@-                        @@                 %######%######@@=@==@@         .@                 @#++++++++++@.           .#############@    
@#@@                         @@++#+@@.             ##############@@   +@*        @#                 @++++++++++++@.           .##############-   
                          @@+++++*++++%@-          ###########@#         .@@    @                 @%+++++++++++++@.          @@######%#######@   
                      .@@++++++@@@*++++++*@@       ########@.                @@@                 @++++++++++++++*@:       #@. %######@#######@   
                   +@#++++++@@     .@@+++++++@@    #####@                       +              @@++++++++++++*@-          @++*@@#####@#######@   
                @@+++++++@@            @@+++++++@@ #@#                             .:         @+++++++++++#@-             @++++++@@##@#######+   
               %@*++++@@                  @@*+++*@@                                    @    @@+++++*+++#@-                 @@+++++++@@#######=   
                  +@@                        -@=                                           @@+++*@=@#@-                       @@*++++++#@%###:   
                     -@=                      @+*@#                                           @@==*=*                            -@%+++++++@@.   
                        .@#+@@==@@            @++++*@@                                           @@#*                               .@@+++++++@@ 
                           .@@=+#@            @@*++++++@@                                          %@                                   @@+++++++
                               @@@               *@*++++++@@                                    @@++@                                      @@++++
                               @@@                  =@#++++++@@                              @@+++++@                                         @@*
                           -@@+++@                     :@%++++++@@.                      .@@+++++++@@                                            
                        @@*++++++@                        .@@++++++@@.                :@%+++++++@@                                               
                     @@++++++%@%                             .@@++++++%@:          +@*+++++++@@                                                  
                 .. -@++++@@.                                   .@@++++++#@=    @@+++++++*@#                                                     
              #       @@+                                           @@++++++*@@+++++++@@:                                                        
          #            @                                               @@++++*+++++@@                                                            
       @@++@            @.                                                @@+*++@@                                                               
    %@*+++++@            @*                                                  @@                                                                  
+@@*++++++*++@+           :@                                                                                                                     
++@+++#@@ @+++*@            @                                                                                                                    
@@@@@     @+++++@            @                                                                                                                   
          @++++++@            @.                                                                                                                 
          @+++++++@:           @#                                                                                                                
          @++++++++#@           :@                                               #=#@.                                                           
          @++++++++++@            @                                            =++*=@@                                                           
          @+++++++++++@            @                                           +=====@                                                           
