     @#############==@@                                                                                .######@#######:.@@=@#                    
     @#############%=+%=.                                                                              .######@#######@    @@                    
     @#############=%==#@                                                                              .##############=       @@                 
     @##########@   +@*==+@.                                                                           .##############:          @@.             
     @######@+         .@@==                                                                           @ @###@########.             #@:          
     @###@                 @@                                                                        .@     @@########                 -@+       
     @%                       @@                                                                    @=         @######                    .@@    
     @.@#                        @@                                                                @              @##%                        @@ 
     @   .@=                        @@.                       **-                                =@                  @@                          
     @      =@:                        =@+                 @##%###@                             @.                 @@@++@@                       
       @@      *@.                        .@@            .%###%#####=                          @                  @++@+++++@@                    
          @@      @@                          @@        +#####@#####@                        @@                 %@+++@@@+++++*@#                 
             @@      @@                          @@     ######@#####@                       @                  @+++++@   @@++++++@@  @%##@@      
  .             @@ *@-                              @@.@######@#####@                     .@                 *@++++++@      @@+++++@########@    
%@===+=. #:     @@.                                   :#######@#####@   @.               @+                 @++++++++@         %@*+######%####+  
=*===%==%==#=@@                                       .#######@#####@ @+@==             @                 -@+++++++++@            +######@#####@ 
@==#===@*#@-                        %-                :#######@#####@%==%+=@.         -@                 @+++++++++++@            @######@######+
  @@==@@.                        @@+*+*@%             :#######@#####@@@. .@@         @.                :@++++++++++++@            @######@######%
                              @@++++%+++++@@          -#######@###@*         @@.    @                 @*+++++++++++++@           @@######@#######
                          .@@++++++@@@+++++++@@       =#######@@.               -@@@                .@++++++++++++++*@        @@  @######@#######
                       =@#++++++@@     @@+++++++@@.   +#####@                      .:              @*++++++++++++*@=          @++@@######@#######
                    @@*++++++@@           @@*++++++%@-+#@%                             @          @+++++++++++*@=             @+++++@@###@#######
                  .@@+++++@@                 :@%++++*@@                                   -     @#+++++++++#@-                -@%++++++*@@#######
                      @@@                        @@-                                          .@*++#@@@=@@-                       @@+++++++@@###%
                         @@                       @+@@                                           @@*@===@                            @@+++++++@@@
                            @@:%@@@@@@           .@++++@@                                           :@@=@                               @@+++++++
                               @@====%            @@++++++@@.                                          @@                                  @@*+++
                                  @@==               @@++++++@@.                                    @@++@                                     =@#
                                  .@@@                  @@++++++%@-                              @@+++++@                                        
                               :@%+++@                     @@++++++*@+                        @@+++++++@@                                        
                            %@*++++++@                        @@++++++*@%                 .@@+++++++@@                                           
                         @@++++++#@%                             @@+++++++@@           +@#+++++++@@                                              
                     .: @+++++@@                                    @@+++++++@@     @@*++++++*@%                                                 
                  @      @%@%                                          @@*++++++@@@+++++++%@:                                                    
              =           -@                                              *@*++++@+++++@@                                                        
           @@+%@            @                                                -@#+@++@@                                                           
+@@.    #@*+++++@            @                                                  :@@                                                              
++++%@@*+++++++++@            @.                                                                                                                 
@@++++*+++#@@-%+++@.           @*                                                                                                                
   @@**@@.   :@++++@@           -@                                                                                                               
             .@+++++*@            @                                                                                                              
              @+++++++@            @                                                                                                             
              @++++++++@            @.                                               @#@%                                                        
              @+++++++++@=           @*                                            @*+**=@                                                       
