                                                                                                                                                 
                                                                                                                                                 
                                            @@@-                                                                                                 
                                         +%#@####@                                                                                               
                                        @###@#####@                                                                                         :%-. 
                                      .#####@#####@                                                                                       @######
                                      %#####@#####@                                                                                      @#######
                                     @######@#####@                                                                                     @#####@##
                                     @######@#####@@@                                                                                  -######@##
                                     @######%#####%#*@@                                                                                -######@##
                                     @######%######+===@                                                                               -######@##
                                     @######%######=+@==                                                                               -#########
                                     @######%####@+@@@%==@                                                                             -#########
                                     @########@       @@%*=@                                                                           =%####@###
          *                          @####@@             @@.                                                                          @:  @@#@###
        %=@=%                        %#@.                   #@:                                                                      @       #@##
       @==#%@-                       @@                        -@+                                                                 *@           =
      @==**#+@                       @  @@                        .@@                                                             @.             
     @*==*=@===@                     @     @@                         @@                    @####@                              .@               
   .=*==@@ @@=*=-                    #@.      @@                         @@               @########@                           @%                
  @==@@       @@@                       +@:      @@                         @@.          @####%#####@                         @                  
 .@#             @@                        -@-     .@@                         +@-      @#####@#####@                       .@                 :@
%                   @@                        :@+    @@                           :@#  @######@#####@                      @-                 @*+
                       @@. % @%. .=@#:@          :@@                                  @#######@#####@                     @                 .@+++
                          +@+*=#===*===@@=+.#@@@.                                     =#######@#####@  @@%.             +@                 @*++++
                             :@#=*+===*=*+%@@                                         =#######@#####@@=%%=@.           @.                .@++++++
                                .@@+==%+@%                        :@@@@               =#######@#####@==@@@==-         @                 @#+++++++
                                    @@.                        #@*++%+++@@.           *#######@#####@=     =@*      @@                 @+++++++++
                                                            @@++++++@++++++%@-        ########@#%@            .@@  @                 @%++++++++++
                                                         @@++++++@@. %@*++++++*@%     @######@+                   @                 @++++++++++++
                                                     .@@++++++%@.       :@@+++++++@@  @###@                          =            @@++++++++++++@
                                                  .@%++++++@@.              @@+++++++@@@                                .:       @+++++++++++@@  
                                                    @@*+@@.                    @@*+@@                                       @  @@++++++#@+@@     
                                                       %@.                       .@@:                                          :@@@@==@=@        
                                                          +@-    #. @-           :%++#@+                                           @@=%=@        
@                                                            -@*==+===           +#+++++*@@                                           @@@        
++@@.                                                           .@%==-             @@+++++++@@                                       .@@@        
+++++#@+                                                           .@-                %@*++++++@@                                 *@#+++@        
@@+++++++@@                                                      @@+*@                   *@*++++++@@                           @@*++++++@        
   @@+++++++@@                                                @@+++++@                      =@#++++++@@                     @@+++++++*@#         
      #@#++++++@@.                                        :@%++++++@@.                         :@%++++++@@.              @@+++++++@@.            
         .@@++++++#@=                                  .@*+++++*@@                                .@@++++++@@.       .@@+++++++@@                
             @@*++++++@@                           .:   .@++@@.                                      .@@++++++%@- -@%+++++++@@                   
                -@@++++++@@                     @         @                                              @@++++++@++++++*@#                      
