   .#######@#####@#==@+                                                                               @#####%#######%  .@@+                      
   :#######@#####@=#==@                                                                               @#####@#######@      @@                    
   -#######@####@@@=%==+@                                                                             @#####@#######@         @@                 
   *#######@%@      #@====                                                                            @#####@#######@            @@              
   %#####@-            -@@                                                                           @  .@##########@               @@.          
   %##@                   .@@                                                                      +@      .@#######@                  *@-       
   -@-                        @@                                                                  @.           @####@                     :@*    
   .@ =@:                        @@                                                              @                @#%                        .@@ 
   .@    #@.                        @@.                    @@##@=                              @@                 .@@@=                         .
    @@      @@                         *@-               @##@#####.                           @                  @*+*++*@=                       
      .@@      @@                         :@#          -####@#####%                         .@                 .@+++@+++++*@=                    
          @@      @@                          @@      .#####@######.                       @=                 @#+++*- @@+++++*@-      .          
             @@    .@@                           @@   @#####%######.                      @                  @+++++#-    @@+++++*@######@@-      
@@@ *:          @@-                                 @@#############.                    =@                 @%++++++#=       @@+++@######@##%     
=@===%@*+@ @+@@                                      @#############: -%=@              @.                 @++++++++#*          @@@######@####*   
+=#==+=%==@@                                         @#############%@##==@            @                 @@+++++++++*#            %######%######  
@=====@@-                        %@@@.               @#############++%@@#=@         @@                 @+++++++++++*@            %############%  
  @@@                         @@+++@++#@+            @#############@      @@       @                 @@++++++++++++*@            ##############@ 
                           @@++++++%+++++*@@         @#########@*            @@. .@                 @+++++++++++++++@         @@ ##############@ 
                       .@@++++++@@ .@@+++++++@@      @######@.                  =+                *@+++++++++++++*@#        .@@@.##############@ 
                    =@#++++++@@        @@+++++++@@   @###@                         .:            @++++++++++++*@#           @++++@@####%#######@ 
                 %@*++++++@@              @@*++++++@@@%                                @       =@++++++++++*@%              @+++++++@@#@#######@ 
                  .@@++@@                    -@@+*@@                                      -   @++++++@@+*@*                   +@#++++++#@@#####@ 
                     .@@                        @@@                                           @@**+=*=%*                         .@@+++++++@@##@ 
                        .@@  .  . .@            @+++@@                                           @@+%+=.                            .@@+++++++@@.
                            @@@=#==@            @++++++@@                                           -@@.                                @@+++++++
                               @@#=@             :@%++++++@@                                        #@#+                                   @@++++
                                  @@                .@@++++++@@.                                 @@+++%:                                      #@*
                                @@+@                   .@@++++++@@.                           @@++++++@.                                         
                            :@@++++@                       @@++++++#@-                     @@+++++++@@.                                          
                         @@*++++++@@                          @@++++++*@*              .@@+++++++@@                                              
                      @@++++++%@+                                @@++++++*@@        =@#+++++++@@                                                 
                  -.   @+++@@                                       @@+++++++@@  %@*++++++*@@                                                    
               +        @#                                             @@+++++++*++++++@@:                                                       
           +@-           -@                                               @@++++*+++@@                                                           
        +@*++#@            @                                                 @@**@@                                                              
+@@  -@*+++++++@            @                                                                                                                    
++++@++++++@@+++@            @.                                                                                                                  
@@++@++@@#  @++++@.           @#                                                                                                                 
   @@@      @+++++@@           :@                                                                                                                
            @++++++*@            @                                                                                                               
            @++++++++@            @                                                                                                              
            @+++++++++@            @.                                              @===@                                                         
            @++++++++++@+           @%                                           @=%==@=                                                         
