 #######@#####@=#==@                                                                               @##############     =@=                       
 #######@#####@@=#==@@                                                                             @#####@########        .@@                    
 #######@#@@     @@=@=@*                                                                           @#####@#######%            @@                 
.######@.           @@@                                                                           @% @@##@#######@               @@              
.##%@                  #@:                                                                       @      *@#######@                  @@           
.@.                       -@*                                                                  :@          -@####@                     @@.       
 @ @@                        .@@                                                              @-              :@#@                        #@:    
 @    @@                         @@                     .@%@@.                               @                  @@@                          -@* 
 @:      @@                         @@                -#######%.                           *@                 .@+@++@@                          .
   =@-      @@                         @@.           @##########.                         @.                 @*++@+++++@@                        
      -@+      @@                         +@-       @###########@                       .@                  @++++@:@%+++++@@                     
         .@*     =@                          :@#   @############@                      @@                 @#+++++@   .@@+++++@@ @####@@          
  .         .@@@.                                @@#############@                     @                  @+++++++@       @@+++*######@##%.       
==+:@@@  . @@                                     @#############@  @%@              .@                 @%++++++++@          @@@######@####%      
==+==%=*@#                                        @#######%#####@*@==+#            @-                 @++++++++++@            @######@#####%     
%%==@@.                        @@@                @#######@#####@==@@+=#.         @                 @@+++++++++++@            @######@######.    
@@@                         @@++@++@@.            @#######@#####@@    +@+       +@                 @+++++++++++++@            @######@######@    
                        .@@+++++@+++++%@-         @#######@##@:          .@@   @.                @@++++++++++++++@         .@@@######@######%    
                     -@%++++++@@%@*++++++*@@      @#######@                  @@                 @++++++++++++++%@#        @@. %#############@    
                  @@*++++++@@      :@@+++++++@@   @###%@                        +             +@++++++++++++%@:          .@++*@@############@    
               @@+++++++@@             @@+++++++@@@@-                              .:        @+++++++++++%@.             #*++++++@@#########@    
               @@*+++@@                   @@*++#@+                                     @   -@++++++@++%@.                  @@+++++++@@######@    
                  #@:                        #@:                                          :@@++@=@=#@.                        @@*++++++#@%##@    
                     =@-        *            @++*@+                                           @@#*==#                            =@#+++++++@@    
                        :@@=+===%            @+++++*@@                                           @@+%                               .@@+++++++@@ 
                           .@%+=*             @@+++++++@@                                         @@@                                   @@+++++++
                              .@@                %@*++++++@@                                   @@+++@                                      @@++++
                             .@@@.                  +@*++++++@@                             @@++++++@                                         @@*
                          #@*+++%-                     -@#++++++@@                      .@@+++++++@@                                             
                       @@+++++++@-                        .@%++++++@@.               =@#+++++++@@                                                
                    @@++++++@@:                              .@@++++++@@.         @@*++++++*@@                                                   
                +.  @+++*@@                                     .@@++++++#@-   @@+++++++%@-                                                      
            .-       @@.                                            @@++++++*@+++++++@@.                                                         
         @-           :@                                               @@++++@++++@@                                                             
      @@++#@            @                                                 @@+@*@@                                                                
   @@+++++++@            @                                                   :                                                                   
+@+++++++@+++@            @.                                                                                                                     
+%+++@@+ @++++@.           @#                                                                                                                    
@@@@     @+++++@@           .@                                                                                                                   
         @++++++*@            @                                                                                                                  
         @++++++++@            @                                                                                                                 
         @+++++++++@            @.                                               =+=@                                                            
         @++++++++++@+           @%                                            *=@#+#=                                                           
         @+++++++++++*@           .@                                          @*==*=#+                                                           
