                               @##@####@                                                                                                         
                              @###@#####@                                                                                         #@=            
                            %#####@#####@                                                                                       @#######=   *    
                           .######@#####@                                                                                     .#####@####@===@   
                           @######@#####@                                                                                    .######@#####@==@@  
                           %######@#####@@@                                                                                  @######@######==%*=@
                           %######@#####@%@@-                                                                                @######%######@@@+#*
                           %######@#####@%===@                                                                               @##############.  @@
                           #######@#####@==%=%                                                                               @##############.    
                           #######@####@.@@**==@                                                                             @#####@########     
                           #######@%@       @@*%=-                                                                           @#####@#######%     
%                          #####@:             @@                                                                           @   @%#@#######@     
+=@                        ##@                    @@.                                                                     .@       @%######@     
=*@:                       @@                        *@-                                                                 @=           %@###@     
=*=@                       @  @@                        .@@                                                             @                +@@     
=#===#                     @     @@                        .@@                    @####@                              =@                  @@@@   
.@@=%=.                    @@.      @@                         @@               @########@                           @.                 @%+@+++@@
    @@+                       #@.     .@%                         @@          .%##########-                         @                  @+++@*++++
       @@                        *@:     .@+                         @@.      %###########@                       @@                 @@++++@ +@#+
          @@                        =@-   .@@                           =@+  @############@                      @                  @++++++@    :
             @@  + @@  @=@+#@          @@:                                 .@#############@                    .@                 %@+++++++@     
                @@=#=@+==*==+@+** @@@@                                      @#######%#####@ :@+@              @+                 @+++++++++@     
                   +@+=#=*=+==@=%@@                                         @#######@#####@@=@@=@            @                 *@++++++++++@     
                      :@#===*@@:                        @@@@@               @#######@#####@=@@@@==         -@                 @++++++++++++@     
                         .@@                         @@+++@+++@@.           @#######@####%@.     @@-      @.                =@+++++++++++++@     
                                                  @@++++++@++++++@@.        @#######@#@+            .@@  @                 @+++++++++++++++@     
                                              .@@++++++@@  @@*++++++#@=     @######@:                   @                :@+++++++++++++*@#      
                                           =@#++++++@@        -@%++++++*@@  @###@                          *            @*+++++++++++*@%         
                                        @@*++++++@@               @@+++++++@@*                                ..      .@++++++++++*@*            
                                          @@++@@                     @@+*@@                                       #  @*+++++#@%*@#               
                                             @@.                       *@@.                                          =@@@@==@=@                  
                                                #@. :  *. @            @*++%@:                                           @@=%=@                  
                                                   +@+=+===.           @++++++*@+                                           @@@                  
                                                      -@*==              @@++++++*@@                                       @@*@                  
                                                         .@                 @@+++++++@@                                 @@++++@                  
%                                                     .@@+@.                   @@+++++++@@                           @@+++++++@                  
++@@                                               :@%++++#+                      *@*++++++@@                     @@+++++++@@.                   
+++++@@                                         @@*++++++@@                          =@#++++++@@              .@@+++++++@@                       
@@++++++@@:                                  -@++++++@@=                                :@%++++++@@.       =@#+++++++@@                          
   @@++++++*@@                           -    =@++@@                                       .@@++++++%@. @@*++++++*@#                             
      =@%++++++@@                     =        .@                                             .@@++++++@++++++%@:                                
         .@@++++++@@.             *@@            @                                               .@@+++@+++@@.                                   
             @@*+++++%@:       =@*+++@            @                                                  @@@@@                                       
                .@@+++++*@% =@*+++++++@            @+                                                                                            
