                                                                                                                                                 
                                                        .:                                                                                       
                                                     @######@                                                                                    
                                                   -#########@                                                                                   
                                                  @###########                                                                                   
                                                 @############                                                                                   
                                                .#############                                                                                   
                                                @#############@:                                                                                 
                                                @##############=@:                                                                               
                                                @##############===@                                                                              
                                                @#############%+===@                                                                             
                                                @############@@#==##@.                                                                           
                                                @#########@     .@@=@%@                                                                          
                                                @#####@#            @@+                                                                          
                   @===@.                       @##@.                  @@                                                                       @
                  @@%=*@                        @@                        @@.                                                                  @ 
                  ##=+=+=.                      @. @@                        *@-                                                             .@  
                .+==@%+==#@                     @.   .@@                        :@%                     @@#@@                               @*   
               @=#=+@#@+=%+@                    @@      .@*                        .@@                @##@####@                            @     
              @=+@*     :@%@                       @@      :@-                         @@           #####@#####@                         -@      
             @@+           .@@                        @@.     +@.                         @@       %#####@#####%                        @.       
          -@-                  @@                        @@.     @#                          @@.   ######@#####%                       @         
       =@-                        @@    .    @@  .          @@@%                                +@@######@#####%                     %@          
    +@:                              @@=@=#+=#==@=@@@%# : @@.                                     #######@#####%  :%@.              @            
 +@:                                    @@==#*@=@@#=#+=@@                                         #######@######-@+==@.           .@             
.                                          %@=+=@==*@%                        =@@@                #######%######=%*@@==@         @#              
                                              -@@@.                        @@*++*++@@             #######%######@.    @@.       @                
                                                                        @@++++++++++++@@          ##########%@           =@*  :@                 
                                                                     @@++++++@@.@@+++++++@@.      #######@:                 .@:                @@
                                                                 .@@++++++@@       @@*++++++#@=   ####@                         @             @++
                                                              +@#++++++@@             :@@++++++*@@%@                               =        #@+++
@@                                                             @@+++@@                   .@@+++@@                                     .-   @+++++
+++@@                                                             @@                         @@                                           @@#+*==
++++++%@-                                                            @@        -.            @++@@                                           :@@#
@@+++++++*@@                                                            @@==#*==@            @+++++%@.                                           
   +@%+++++++@@                                                            @@===@             @@++++++#@-                                        
       @@+++++++@@.                                                           *@@                @@++++++*@*                                  %@*
          @@*++++++%@-                                                       @@+@                   @@++++++*@@                            @@++++
             .@@++++++*@@                                                .@@++++@                      @@+++++++@@                      @@+++++++
                 @@+++++++@@                                          =@#++++++@@                         @@*++++++@@               .@@+++++++@@.
.@@                 +@#++++++@@                                    @@*+++++*@@                               #@*++++++@@         .@@+++++++@@    
    @@                  @@++++++%@-                            .:   @+++@@.                                     =@#++++++@@   +@#+++++++@@       
       @@                  @@*+++++*@@                      %        @%                                            :@#++++++@*++++++*@*          
          @@                  :@@++++++@@               -@            @                                               .@%+++*++++@@.             
