                                                                         @######@#####@                                                          
                                                                         #######@#####@@.                                                        
                                                                         #######@#####@*@@                                                       
                                                                         #######@#####@@==*@                                                     
                                                                         #######@#####@====@                                                     
                                                                         #######@####@#@+#===@                                                   
                                                                        .#######@#@      -@#+*=:                                                 
                                              .                         .#####@*            .@@                                                  
                                           .====@                       .##@.                   @@                                               
                                          =#===+@                       .@@                        @@                                            
                                          @==+%==@                       @ .@#                        @@.                                        
                                        .@+==+====@.                     @    :@-                        +@-                    @%##%@           
                                       @=*=+@*@@*=#@                     @@      =@:                        :@#               @##%#####*         
                                      @==@*      *@*.                       @@      %@.                        .@@          .%##########.        
                                     :@=            :@*                        @@      @@                          @@      .############@        
                                  -@=                  .@@                        @@    .@@                           @@   @############@        
                               =@-                        .@@  . %.  @%@.-@          @@*                                 %@#############@        
                            =@:                               @@=#=##=%====@%=@ #@@@.                                     @#############@ .@=@   
                         +@:                                     @@=+#=@==+=*==@@                                         @#############@@=#+=@  
                      #@.                                           @@=====*@*                        =@@@*               @#######%#####@=*@@@=+ 
                   #@.                                                 %@@.                        @@*++@++*@@            @#######@#####@.     @@
@               %@.                                                                             @@++++++@++++++@@         @#######@#@@           
@              @@                                                                            @@++++++@@  @@+++++++@@      @######@+              
@              @++@@.                                                                    .@@++++++@@        @@+++++++@@:  @###@                  
@              @*++++#@*                                                              *@#++++++@@              *@#++++++*@@@                     
@              :@++++++++@@                                                             @@++@@                    .@@++@@                        
@@=               @@*+++++++@@                                                             @@                        @@@                         
   .@%               -@@+++++++@@.                                                            @@  .  .  @            @+++@@                      
      .@@                @@+++++++#@+                                                            @@+=@==+            @++++++@@                   
          @@                @@#+++++++@@                                                            @@#=+             .@@++++++@@.               
             @@                .@@+++++++@@                                                            @@                 @@++++++%@.            
                @@                 @@+++++++@@.                                                      @@+@                    @@++++++#@=         
                   @@.                -@%++++++#@*                                               .@@++++@.                      @@++++++*@#      
                      +@-                 @@+++++++@@                                         +@#++++++@@                          @@+++++++@@   
                         :@*                 @@*++++++@@                                   @@*+++++#@@                                @@+++++++@@
                            .@@                 .@@++++++@@.                           ..   @#++@@.                                      @@++++++
                                @@                  @@++++++#@+                     %        =@                                             *@*++
                                   @@                  =@%+++++*@@              :@@           .@                                               =@
                                      @@                  .@@++++++@@        :@#+++@            @                                                
                                         @@.                  @@*+++++@@. .@#+++++++@            @                                               
                                            #@:                  .@@+++++@++++++@@+++@            @*                                             
                                               -@+                   @@++@++#@@  @++++@#           -@                                            
                                                  .@@                   +@@      @+++++*@            @                                           
                                                     .@@                         @+++++++@            @                                          
