                                                                                                                                                 
                                                                                                                                                 
                                                                                                                                                 
                                                =@@                                                                                              
                                             +%#@####@                                                                                           
                                            @###@#####@                                                                                         .
                                          :#####@#####@                                                                                       @##
                                          ######@#####@                                                                                      @###
                                         @######@#####@                                                                                     %####
                                         @######@#####@@+                                                                                  @#####
                                         @######@#####@%@@-                                                                                @#####
                                         @######@#####%@===@                                                                               @#####
                                         %######@#####%==*=+                                                                               @#####
                                         %######@####@*@%@==+@                                                                             @#####
                                         #######%#@      .@@@@=%                                                                           @#####
              .                          #####@@             @@                                                                           @.  @##
            ==*=@                        ##@.                   @@                                                                       @       
          .@==+%@.                       @@                        @@.                                                                 #@        
          @===*==@                       @  @@                        *@-                                                             @.         
         @@==#=+==**                     @     @@                        .@@                    @%###@                              .@           
       +=%==@@-@%=@+                     @@      .@*                        .@@               @########@                           @#            
      @==@@      .@@=                       @@.     :@-                         @@           @##########+                         @              
     .@@             @@                        @@      =@.                         @@       @###########@                       :@               
  .@@                   @@                        @@.    @@                           @@.  @############@                      @:                
@#                         @@  . @:  :*@..@          #@@                                 =@#######%#####@                     @                 .
                              @@=@=@==*====@@=+ =@@@:                                     @#######@#####@  @#@              *@                 @*
                                 @@==@=@==#=++%@@                                         @#######@#####@@+*%=@            @.                .@++
                                    *@+===%=@@                        .@@@@               @#######@#####@==@@@==.        .@                 @*+++
                                       -@@:                        +@#++@+++@@            @#######@#####@=     @@.      @@                .@+++++
                                                                @@++++++@++++++@@.        @#######@#%@            -@%  @                 @#++++++
                                                             @@++++++#@: @@+++++++@@.     @######@#                   @                 @++++++++
                                                          @@++++++%@.       @@*++++++#@+  @###@.                         @            @@+++++++++
                                                      .@%++++++@@.             .@@+++++++@@@                                -        @+++++++++++
                                                        @@++@@.                    @@++@@                                       -  @@++++++@%+@@ 
                                                           @@                        :@@.                                          @@%#@==#=@    
@=                                                            @@.    .  @.           #*++@@.                                          .@@=%=@    
++*@@                                                            @@==#===.           @++++++%@.                                           @@@    
++++++@@                                                            %@===.             @@++++++#@=                                       .@@@    
@@+++++++@@.                                                           =@                 @@++++++*@*                                 =@#+++@    
   @@*++++++#@=                                                      @@+#=                   @@++++++*@@                           %@*++++++@    
      .@@++++++*@@                                                @@++++*#                      @@+++++++@@                     @@+++++++*@%     
          @@+++++++@@                                         :@@++++++@@.                         @@*++++++@@               @@+++++++@@:        
             =@%++++++@@                                   .@*+++++*@@                                *@*++++++@@         @@+++++++@@.           
                .@@++++++%@=                           .=   =@++@@.                                      =@#++++++@@. .@@+++++++@@               
