                                                            .=                                                                                   
                                                         @######@                                                                                
                                                       :#########%                                                                               
                                                      @###########                                                                               
                                                     @############.                                                                              
                                                     #############.                                                                              
                                                    =#############@#                                                                             
                                                    *#############@=@=                                                                           
                                                    @#######%#####@+==@                                                                          
                                                    @#######%#####@=*==@                                                                         
                                                    @#######@####@@@=+++@:                                                                       
                                                    @#######@#@      @@=@*@                                                                      
                                                    @#####@#            @@@                                                                      
                       @===*+                       @##@                   @@.                                                                   
                      @@#==%.                       @@                        *@-                                                                
                      @@======                      @: @@                        :@%                                                             
                    .@==###==*@                     @.    @@                        .@@                     @@#%@                               @
                   @=#=*@#@@=@=@                    -@.      @@                         @@                @##@####@                            @ 
                  @==@*      @@@                       #@.     .@@                         @@           =####@#####@                         .@  
                 @@=            @@                        *@:     .@+                         @@.      =#####@######                        @-   
              -@=                  @@                        =@-     @@                          +@=   %#####@######                       @     
           -@-                        @@    ..   @@. :          -@@*                                .@@######@######                     +@      
        +@:                              @@=@=@=++==#=@@@*@ - @@.                                     %######@######  :@@=              @.       
     +@:                                    *@+=@=#=##%=+==@@                                         %######%######-@#==@-            @         
  *@:                                          :@#==@==+@*                        =@@@                %#############=@+@@==@         @@          
@.                                                .@@@.                        @@*++*++@@             %#############@.    @@:       @            
                                                                            @@++++++*+++++@@.         ##########@@           .@@  .@             
                                                                         @@++++++@@.@@+++++++#@=      #######@:                  @=              
                                                                     .@@++++++@@.      =@%++++++*@@   ####@                         %            
+@@                                                               +@#++++++@@             .@@+++++++@@%@                               ..       +
++++@@                                                             @@+++@@                    @@+++@@                                      *   @+
+++++++@@:                                                            @@.                        @@.                                          *@@
 @@+++++++*@%                                                            #@.       .=            @++%@:                                          
    @@*+++++++@@                                                            +@+*====@            @+++++#@=                                       
       .@@+++++++@@.                                                           -@*==@             @@++++++*@@                                    
           @@+++++++@@:                                                           .@@                @@+++++++@@                                 
              *@%++++++*@#                                                       @@+@                   @@+++++++@@                            @@
@                 @@+++++++@@                                                .@@++++@                      #@*++++++@@                      @@+++
  @@                 @@*++++++@@                                          =@#++++++@@                         =@#++++++@@                @@++++++
     @@                 :@@++++++@@:                                   @@*+++++*@@                               :@%++++++@@.        .@@+++++++@@
        @@                  @@++++++*@@                            .:   @+++@@.                                     .@@++++++@@.  =@#+++++++@@   
           @@                  *@#++++++@@                      @        @@                                            .@@++++++#*++++++#@*      
              %@.                 .@@++++++@@               :@            @-                                              .@@++++++++@@.         
                 =@-                  @@*+++++%@:        :@#++@:           +@                                                 @@++@@             
