                                                                                                                                                 
                                                                                                                                                 
                                                                                                                                                 
                                                =@##%@                                                                                           
                                              @#########                                                                                         
                                             @##########                                                                                        -
                                           .############                                                                                       @#
                                           @############                                                                                      @##
                                          @#############.                                                                                    @###
                                          @#############==                                                                                   ####
                                          @#############+@+@                                                                                 ####
                                          @#############*+%==+                                                                               ####
                                          @#############@*=*=@                                                                               ####
                                          @##########%@  @@=%==.                                                                             ####
                                          @#######@:        @@==@                                                                           *@@##
              +@@                         @###%@               +@-                                                                         @.   -
             @====                        @@=                     :@%                                                                     @      
            @=#%+=#                       @*@.                        @@                                                                @%       
           @=@+*=+#                       @.  @@                         @@                                                            @         
         -+==#=@=#==@                     @      @@                         @@.                  @#@###@                             .@          
         %@=@@   @@==@                     :@+      @@                         @@.             @###@#####%                          @-           
       @=@@         @@                        .@#      @@                         =@=         @####@#####@                         @             
      @@               @@.                        @@      @@                         .@@     @#####@#####%                       +@              
   @@                     *@:                        @@  @@.                             @@ *######@#####%                      @.               
@@                           -@+@@@+@.@=++@=.        .@@                                    %######@#####%   .                 @                 
                                .@@=#=%==#@%=%*=@@+@#                                       #######@#####%  +==@             @@                 @
                                    @@==#=@=%%=@@.                                          #######@######@#=+=@*           @                 -@+
                                       @@=@=@@                         @@+*@@.              #######%######=@@ #@*%        .@                 @+++
                                          +                        .@@++++++++#@-           #######%####@-       .@@     @=                :@++++
                                                                =@#++++++@*++++++*@%        #########@               @@ @                 @*+++++
                                                             @@*++++++@@   .@@+++++++@@     #####%@                                     .@+++++++
                                                          @@+++++++@@          @@+++++++@@  ##@-                           .:          @*++++++++
                                                        @*++++++@@                @@++++++#@*                                  %      @++++++++++
                                                          =@#@#                      =@@@.                                        = @#+++@*@*@@@ 
@                                                            :@+                       @*@#                                           @@@==+=@   
++@@                                                            .@% @-@@@@@            @++++@@                                           @@=+@   
+++++@@.                                                            @@==@=@            @*++++++@@                                           +@   
@+++++++#@+                                                            @@=@              +@*++++++@@                                      @@+@   
  =@@+++++++@@                                                          .@@                 -@#++++++@@                               .@@++++@   
      @@+++++++@@                                                    *@#++@                    .@%++++++@@                         :@%+++++++@   
         @@*++++++@@.                                             @@++++++@                       .@@++++++@@.                  +@*+++++++@@     
            .@@++++++#@+                                       @@++++++@@*                           .@@++++++%@:            @@+++++++*@%        
                @@+++++++@@                                :.@++++++@@                                   @@++++++*@+      @@+++++++%@-           
@:                 =@%++++++@@                          *     @#@@-                                         @@++++++*@%@@+++++++@@.              
