                                                                  -#####@#####@                                                                  
                                                                 .######@#####@                                                                  
                                                                 @######@#####@                                                                  
                                                                 @######@#####@@#                                                                
                                                                 @######@#####@@@@-                                                              
                                                                 %######@#####@%===@                                                             
                                                                 %######@#####%==*=*                                                             
                                                                 #######@####@=@%@+==@                                                           
                                                                 #######@#@      .@@@@=*                                                         
                                      :                          #####@#             @@                                                          
                                    ==*=@                        ##@.                   @@                                                       
                                  .%===#@.                       @@                        @@.                                                   
                                  @==++==@                       @  @@                        =@=                                                
                                .@@==+=*==+#                     @     @@                        .@@                    @####@                   
                               %=*==@%:@@=@+                     @@      .@%                         @@               @########@                 
                              @==@#      .@@-                       @@      :@=                         @@           @##########=                
                             .@#             @@                        @@.     -@:                         @@       @###########@                
                          .@*                   @@                        %@.    @@                           #@:  @############@                
                       :@=                         @@  : @-  =+@::@          #@#                                 -@#######%#####@                
                    -@=                               @@=@=@==+====@@=+ #@@@.                                     @#######%#####@  @*@           
                 -@-                                     %@==@=#==*=*=#@@                                         @#######@#####@@=#@=@          
              =@:                                           +@+===#+@%                        -@@@@               @#######@#####@=+@@@==.        
           +@:                                                 :@@.                        @@*++@+++@@            @#######@#####@:     @@.      @
        *@:                                                                             @@++++++@++++++@@         @#######@#%@            :@@  @ 
       @@.                                                                           @@++++++@@. @@+++++++@@:     @######@+                   @  
       @*+#@+                                                                    .@@++++++@@.       #@#++++++*@#  @###@                          
       .@+++++@@                                                              -@#++++++@@              .@@+++++++@@@                             
        @++++++++@@                                                             @@++@@.                    @@++@@                                
          #@#+++++++@@.                                                            @@                        -@@.                                
              @@+++++++#@+                                                            @@     -  @            %*++@@.                             
@                @@*+++++++@@                                                            @@==#===.           @++++++%@:                          
  @@                :@@+++++++@@                                                            *@+==              @@++++++#@=                       
     @@.                @@+++++++@@.                                                           -@                 @@++++++*@#                    
        #@:                %@#++++++#@+                                                      @@+%:                   @@+++++++@@                 
           -@+                .@@+++++++@@                                               .@@++++##                      @@+++++++@@              
              .@@                 @@+++++++@@                                         =@%++++++@@.                         @@*++++++@@           
                  @@                 -@@++++++@@.                                  :@*+++++*@@                                +@*++++++@@        
                     @@                  @@++++++#@+                           .:   +@++@@.                                      -@#++++++@@  -@#
                        @@                  @@*+++++*@@                     @         @                                             .@%++++++@+++
                           @@.                 .@@++++++@@              .@@            @                                               .@@+++@+++
                              %@:                  @@++++++@@.       .@%+++@            @.                                                 @@@@@ 
                                 =@=                  -@@+++++#@+ .@@+++++++@.           @=                                                      
                                    .@@                   @@+++++*++++++@@+++@=           =@                                                     
                                       .@@                   @@*+*++#@@  @++++*@            @                                                    
