                                                                             @#############=@                                                    
                                                                             @#############=**@                                                  
                                                                             @#############====#.                                                
                                                                             @#############@%+==-                                                
                                                                             @###########@=%@*+===                                               
                                                                             @########@       -@*=*@                                             
                                                  %.                         @####@%             .@@                                             
                                                @====.                       @#@.                    @@                                          
                                               @=@+=+@                       @@*                        @@                                       
                                              @=+%%**+                       @  :@-                        @@.                                   
                                             @===*@====@                     @     =@:                        #@:                   @%@##@+      
                                            =*==@@ @@==*@                     @@      %@                         -@*              ####@####@     
                                          %==@%       *@@                        @@      @@                         .@@          @####@#####@    
                                         .@%             -@=                        @@      @@                          @@      @#####@#####@    
                                      .@%                   .@%                        @@   .@@                            @@  -######@#####@    
                                   :@*                         .@@ @.@@@  *%@:@          -@#                                  @@######@#####@    
                                :@+                                @@=%=%==#=%=#%==@@@@@.                                      #######@#####%  @=
                             :@+                                      @@==@=%%+#*==@@                                          #######@#####%@=@*
                          -@-                                            @@@=%=+@#                        :@%#@=               #######@#####%=%@@
                       =@-                                                  @@.                        #@*++++++*@@            #######@#####@+   
    @.              +@:                                                                             @@++++++*+++++++@@         #######%#%@       
   *=.              @@                                                                           @@++++++%@.  @@+++++++@@     .######@-          
 :@=#=              @++@@.                                                                   .@@++++++%@.        @@+++++++@@. .###@.             
=@==*+              @+++++#@=                                                              @#++++++@@.              *@#++++++#@@                 
=@===*              @@+++++++*@@                                                            .@@+@@                     .@@+@@                    
*==@@#@:               @@++++++++@@                                                             @@                        @@@                    
@@      -@+               -@@+++++++@@.                                                            @@  - @*.@@            @+++@@                 
           .@@                @@+++++++#@=                                                            @@==@==@            @++++++@@              
              .@@                %@*++++++*@@                                                            @@==@             .@@++++++@@.          
                  @@                .@@+++++++@@                                                            @@                 @@++++++@@.       
                     @@                 @@+++++++@@.                                                     @@++@                    @@++++++#@-    
                        @@.                =@%++++++#@=                                              .@@+++++@                       @@++++++*@* 
                           #@:                 @@++++++*@@                                        -@%++++++@@.                          @@++++++*
                              -@+                 @@*++++++@@                                   @*+++++*@@                                 @@++++
                                 .@@                 .@@++++++@@.                          .:    @++@@                                        @@+
                                     @@                  @@++++++#@=                    @         @.                                             
                                        @@                  +@%+++++*@@             .@@.           @@                                            
                                           @@                   @@++++++@@       .@%+++@%           .@                                           
                                              @@                   @@*+++++@@..@@+++++++*@            @                                          
                                                 %@.                  .@@+++++@+++++@@@+++@            @                                         
                                                    =@-                   @@++@+#@@   @++++@            @.                                       
                                                       :@#                   *@       @+++++@-           %@                                      
                                                          .@@                         @++++++#@           .@                                     
                                                              @@                      @++++++++@            @                                    
