                                                                                                                                                 
                                                                                                                                                 
                                                                                                                                                 
                                                 @####%%                                                                                         
                                               @########@                                                                                        
                                             -###########                                                                                        
                                            :############.                                                                                      %
                                            @############:                                                                                    .##
                                           :#######%#####*                                                                                    @##
                                           -#######%######=                                                                                   @##
                                           *#######%#####@@=@:                                                                                @##
                                           %#######@#####@%==#@                                                                               @##
                                           %#######@#####@=%==%+.                                                                             @##
                                           @#######@##@    @@=*=@@                                                                            @##
                                           @######@@          @@=@                                                                           @:=@
              *@==@                        @###@                 =@=                                                                        @    
              @=@+=                        @%                       .@@                                                                   +@     
             @@*==**-                      +=#@.                       .@@                                                               @.      
            @==#====@.                     *-   @@                         @@                       @@@.                                @        
          @==#+#@@=+=@.                    #*      @@                         @@                 =##@####@                            @%         
         #==%@.    @@=@                      .@%      @@                         #@:            @###@#####@                          @           
        #%@.          @@                        .@@      @@                         :@+        #####@######.                       .@            
      %@.                @@.                       .@@      @@                         .@@    @#####@######.                      @-             
   @@                       +@-         :.             @@%@-                               @@@######@######.                     @               
@@.                            :@@=@@=@@=+=*=@ @@-    @@                                     @######%######.  @@               =@                
                                  .@@=%=%=+*#=#%+==@@                                        @#############..#=#@             @.                 
                                      @@==@*===#@=                        @@                 %#############@%=@==@@          @                 @%
                                         @@*@@.                        @@++%+@@.             %#############@@   -@@        @@                 @++
                                                                    @@+++++#++++#@*          %##########@%         .@@    @                 @@+++
                                                                .@@++++++@@@#++++++*@@       %#######@.                @@@                 @+++++
                                                             =@#++++++@@     .@@+++++++@@    %####@                       -              @@++++++
                                                          @@*++++++@@            @@+++++++@@ %@%                             .-         @++++++++
                                                         +@*++++@@                  @@*+++*@@                                    @    #@+++++*+++
                                                            -@@                        :@#                                           @@+++#@+%+@=
+@@                                                            .@%                      @+*@@                                           @@=+#==  
++++@@                                                            .@@*@@==@@            @+++++@@                                           @@%=  
+++++++@@:                                                            @@=#*@            %@*++++++@@                                          %@. 
 @@*++++++*@%                                                            @@@               =@#++++++@@                                    @@++@. 
    .@@+++++++@@                                                         @@@                  :@%++++++@@                              @@+++++@  
        @@+++++++@@.                                                 :@@+++@                     .@@++++++@@.                       @@+++++++@@  
           +@#++++++@@:                                           @@*++++++@                         @@++++++%@.                .@@+++++++@@     
              .@@++++++*@#                                     @@++++++#@@                              @@++++++#@=          =@#+++++++@@        
.                 @@*++++++@@                              .: .@++++@@.                                    @@++++++*@#    @@*++++++*@%           
 =@-                 :@@++++++@@                        @       @@*                                           @@+++++++@@+++++++%@:              
