                                                                                                                                                 
                                                                                                                                                 
                                                                                                                                                 
                                                @@@@.                                                                                            
                                             .@#######:                                                                                          
                                            @##########                                                                                         :
                                           @###########.                                                                                      @##
                                          @############.                                                                                     @###
                                         .#############-                                                                                    @####
                                         :#######%#####*@                                                                                   @####
                                         +#######%#####@@=@                                                                                 @####
                                         %#######%#####@*==#@                                                                               @####
                                         %#######@#####@*=*=@                                                                               @####
                                         @#######@###@%-@#=%===                                                                             @####
                                         @#######@@.      .@@=@@                                                                            @####
              =:                         @####%@              @@                                                                          -@   @#
            @====+                       @#@:                    @@                                                                      @.      
           @=+===@                       *@@                        @@.                                                                 @        
          :=@**++=.                      *-  @@                        *@:                                                            @@         
         @===#+=+=%%                     %:    .@*                        :@#                   +@@###@                              @           
        @%==@@ +@*=@@                     @@      .@=                        .@@              .%##@#####:                          .@            
      .+=@@       :@@                        @@      =@:                         @@          @####@#####@                         @*             
      @@             .@@                        @@      *@.                         @@      @#####@######.                       @               
   @@                    @@                        @@.   @@                            @@.  ######@######.                     :@                
@@                          @@ @:@@@  @*@-@:         .@@                                  =@######@######.                    @:                 
                               @@=@=@==++*=%@=*@*@%@-                                      @######%######. @==@              @                 *@
                                  @@=*@=#*#*+==@@                                          %#############@=@=%=@           #@                 @++
                                     #@+=*==@@                        .@@@@@               %#############=*@@@@=@         @                 =@+++
                                        -@=                        -@%+++#+++@@            %############@@      @@.      @                 @+++++
                                                                @@*+++++**++++++@@         %#########@             -@% @#                :@++++++
                                                             @@++++++*@=  @@+++++++@@.     %#####@%                   ..                @*+++++++
                                                          @@++++++#@=        @@*++++++#@+  %##@.                          @           .@+++++++++
                                                       @@++++++#@-              .@@++++++*@@                                 -       @*++++++++++
                                                         @@+#@:                     @@+@@                                        =  @+++++#@@+@@ 
                                                            @@                        @@@                                           @@@@==@%*    
%@-                                                            @@  # =@.+@            @+++@@                                           .@@=@+    
+++*@@                                                            @@*=%==@            @++++++@@.                                           @@    
+++++++@@                                                            %@==@              @@++++++%@:                                      .@@@.   
 @@+++++++@@.                                                           %@                 @@++++++*@+                                :@%+++@    
    @@*++++++%@=                                                     @@*+@                    @@++++++*@%                          *@*++++++@    
       .@@++++++*@@                                               @@+++++@                       @@+++++++@@                    @@+++++++*@@     
           @@+++++++@@                                        .@@++++++@@-                          @@+++++++@@              @@+++++++#@=        
              =@%++++++@@.                                  @#++++++@@                                 @@*++++++@@        @@+++++++@@.           
                  @@++++++%@-                           =    @*+@@:                                       +@*++++++@@ .@@+++++++@@               
