                                                                       *######@#####@                                                            
                                                                       @######@#####@                                                            
                                                                       @######@#####%=@                                                          
                                                                       @######@#####%==@@                                                        
                                                                       @######%######@=#%=                                                       
                                                                       @######%#####%=%==#@.                                                     
                                                                       @######%##%@   +@+==*@                                                    
                                                                       @######@.         :@%=.                                                   
                                          @@@@.                        %##%@                .@@                                                  
                                          @=@=@                        @-                       @@                                               
                                        .=#%*#*@                       @.@*                        @@                                            
                                       .%====@=@*                      @   :@-                        %@.                      .@@-              
                                      @==+=@@====@                     @      =@:                        =@=                 @######@            
                                     @==@@    @@==.                      @@      %@.                        .@%            -##########.          
                                    @@@          =@-                        @@      @@                          @@        @#####%#####@          
                                  @@                :@*                        @@      @@                          @@    .######%#####@          
                               @@                      .@@          .             @@ @@.                              @@.@######@#####@          
                            @@                             @@=@@=*@%=====  @-     @@                                    +#######@#####@   @      
                         @@                                   @@=*=+===*==*=**+@%                                       +#######@#####@ @#%+.    
                      @@                                         @@==%==**+@@.                        @:                +#######@#####@+==*#+@.  
                   @@                                               @@==@@                         @@+#+*@%             *#######@#####@@@   @@   
                @@                                                                              @@++++@+++++@@          ########@###@:         @@
             @@                                                                             -@%++++++@@@+++++++@@       %#######@@               
             *#@@                                                                        @@*++++++@@     @@+++++++@@.   @####%@                  
             .@+++@@:                                                                 @@+++++++@@           @@*++++++%@-@#@-                     
              @++++++*@@                                                            .@@+++++@@                 :@@++++#@*                        
               @@++++++++@@                                                             @@@                        @@.                           
-@+               %@#+++++++@@.                                                            @@                      :@+@@                         
   .@@               .@@+++++++%@:                                                            @@*#@@*@+-           -#++++@@                      
       @@                @@+++++++*@%                                                            @@===+-            @@++++++@@                   
          @@                =@@+++++++@@                                                            @@=.              .@@++++++@@.               
             @@                 @@+++++++@@                                                         .@@#                  @@++++++#@:            
                @@                 @@*++++++@@:                                                  *@*+++@                     @@++++++*@+         
                   #@.                .@@++++++*@@                                            @@+++++++@                        @@++++++*@@      
                      =@-                 @@+++++++@@                                      @@++++++@@=                             @@+++++++@@   
                         .@#                 =@%++++++@@.                              -. @+++++@@                                    @@+++++++@@
                             @@                  @@++++++%@:                        +      @@@:                                          %@*+++++
                                @@                  @@*+++++*@%                 *           *@                                              *@*++
                                   @@                  .@@++++++@@           @@+@@           .@                                                =@
                                      @@                   @@++++++@@     @@+++++*@            @                                                 
                                         @@.                  +@%+++++@@@++++++++++@            @                                                
                                            +@-                  .@@++++++++@@#**+++@            @-                                              
                                               :@*                   @@**@@    +*++++@+           +@                                             
                                                  .@@                          =#+++++*@           .@                                            
