                                                                      @#####@#####@                                                              
                                                                     @######@#####@                                                              
                                                                     @######%#####%*@                                                            
                                                                     @######%######+=@@                                                          
                                                                     @#############====@                                                         
                                                                     @#############+*%==.                                                        
                                                                     @###########@=@@%@==*                                                       
                                                                     @########@       @@#==@                                                     
                                          @                          @####@#             #@:                                                     
                                        @=%=+                        @#@.                   -@+                                                  
                                       @=+@*@%                       @@.                       .@@                                               
                                      @==*%@#@                       @  @@                         @@                                            
                                    .@===**@===@                     @     @@                         @@                    @####@.              
                                   .=*==@@ @@===%                    :@+      @@                         @@.              @###%####@             
                                  @==@@       @@@                       :@*      @@                         *@:          @####%#####@            
                                 .@@             @@.                       .@%      @@                         :@#      @#####@#####@            
                              .@#                   %@.                       .@@    @@                           .@@  @######@#####@            
                           :@+                         =@- @ @@: .=@@:@          -@%                                  @%######@#####@            
                        :@+                               :@%==+===%===@@=+-%@@@.                                     .#######@#####@  @#++      
                     :@=                                     .@@==*=*=*=*=+@@                                         :#######@#####@@=@@=*.     
                  -@-                                            @@#==*+@@                        -@%@@               :#######@#####@=+@@@+=*    
               =@:                                                  @@.                        %@*++#+++@@:           -#######@#####@=     .@@   
            +@:                                                                             @@++++++%++++++*@#        =#######@#%@             @@
           =@@                                                                           @@++++++%@. -@%+++++++@@     +######@-                  
            @++@@                                                                    .@@++++++@@.       .@@+++++++@@  +###@                      
            @+++++@@                                                              .@#++++++@@.              @@+++++++@@@                         
            @#+++++++%@-                                                            +@*+@@.                    %@*+@@                            
              .@@+++++++*@@                                                            -@+                        @@*                            
@@.               @@*+++++++@@                                                            .@#    @. @*            @++*@@                         
   %@:               :@@+++++++@@                                                            .@@==#==@           :%++++++@@                      
      -@+                @@+++++++%@-                                                           .@@==*             #@*++++++@@                   
         .@%                #@#++++++*@@                                                            @#                =@#++++++@@                
            .@@                .@@+++++++@@                                                      @@++@                   :@%++++++@@             
                @@                 @@*++++++@@.                                               @@+++++@                      .@@++++++@@.         
                   @@                 :@@++++++%@-                                        -@%++++++@@.                         .@@++++++%@:      
                      @@.                 @@++++++*@@                                   @*+++++*@@                                 @@++++++#@=   
                         #@.                 #@*++++++@@                           .:    @++@@                                        @@++++++*@#
                            =@=                 .@@++++++@@.                    @         @                                              @@++++++
                               .@%                  @@*+++++%@:             .@@            @.                                               @@+++
                                  .@@                  -@@+++++*@@       .@@+++@            @%                                                 @@
                                      @@                   @@++++++@@ .@@+++++++@#           .@                                                  
                                         @@                   %@*+++++*+++++@@%++*@            @                                                 
                                            @@                   .@@++*+#@@  :@++++@            @                                                
                                               @@.                   @@      .@+++++@            @.                                              
