                                                                              #######@#####@=%                                                   
                                                                              #######@#####@=#+.                                                 
                                                                             .#######@#####@+%=#@                                                
                                                                             .#######@#####@*=#=@                                                
                                                                             .#######@###@* @@=@==@                                              
                                                                             :#######@@        @@==+                                             
                                                  %@                         :####@@              *@-                                            
                                                :====@                       -#@.                    :@%                                         
                                               @=====##                       @@.                        @@                                      
                                              .+=@==#=#                       @  @@                         @@                                   
                                             @=*=+==#=#=.                     @     @@                         @@                   *%@###@      
                                            @*==@@  @@==#                     :@+      @@                         @@.             .%##@#####@    
                                           *=@@        @@=                       .@#      @@                         +@=         @####%######.   
                                         .@@              @@.                       .@@      @@                         .@@     +############+   
                                      .@@                    #@:                        @@   @@                             @@  %############*   
                                   .@@                          =@=+@.@@: @=@@@@         :@@                                   @#############*   
                                .@#                                .@@@*=#==%==*+=+@@@@@:                                      @#############* @=
                             .@%                                      .@@#=*=%+=*==@@                                          @#############@=#=
                          .@#                                             @@====@@                        .@@@@@.              @#############%=@@
                       :@+                                                   @:                        +@#+++@+++%@-           @#######%####@=   
    @@              -@=                                                                             @@*+++++#@++++++*@#        @#######@%@       
   @=@              @@@                                                                          @@++++++#@:  :@@+++++++@@     @#####@+          
 .@=*@              @+++@@                                                                    @@++++++#@:         @@+++++++@@  @##@.             
@%==+@              @*+++++@@.                                                             @@++++++%@.               @@+++++++@@                 
=%==*@              .@@+++++++#@=                                                            =@*%@.                     +@#@@                    
+==@@ @@                @@+++++++*@@                                                            :@*                       @*@*                   
@@       @@.               @@*+++++++@@                                                            .@% @..@@.*            @++++@@                
            +@-               .@@+++++++@@.                                                            @@==%=*            @*++++++@@             
               :@*                @@+++++++#@=                                                            @@=#              +@*++++++@@          
                  .@@                +@%++++++*@@                                                           %@                 -@#++++++@@       
                      @@                 @@+++++++@@                                                     @@++@                    :@%++++++@@    
                         @@                 @@*++++++@@.                                              @@+++++@                       .@@++++++@@.
                            @@                 .@@++++++#@=                                       :@@++++++@@.                          .@@++++++
                               @@.                 @@++++++*@@                                 =@%+++++*@@                                  @@+++
                                  #@:                 *@%++++++@@                          .:    =@+@@.                                        @@
                                     -@+                  @@++++++@@.                   @          @                                             
                                        .@%                  @@*+++++#@=             @@@            @                                            
                                           .@@                  :@@+++++*@@       @@++++@            @.                                          
                                               @@                   @@++++++@@ @@++++++++@            @*                                         
                                                  @@                   #@#++++@+++++@@@+++@#           -@                                        
                                                     @@.                  .@@+@+#@@   @++++*@            @                                       
                                                        #@:                   @       @++++++@            @                                      
                                                           =@=                        @+++++++@            @.                                    
                                                              .@.                     @++++++++@-           @%                                   
