                                                                    @#####@#####@                                                                
                                                                   =######@#####@                                                                
                                                                   @######@#####@                                                                
                                                                   @######@#####%=@                                                              
                                                                   @######%######==%@                                                            
                                                                   @######%######%=*@=                                                           
                                                                   @######%#####%=#==%@.                                                         
                                                                   @#########%@   =@*=++@.                                                       
                                                                   @######@.         .@@=.                                                       
                                      @@%@.                        @###@                .@@                                                      
                                      @=@=@                        @=                       @@                                                   
                                    .=#%#**%                       @.@#                        @@                                                
                                   .%===+@=@%                      @   .@+                        #@:                      .@@=                  
                                  @==*=@@==+=@                     @      :@-                        -@*                 @######@                
                                 @=+@@    #@+=:                      @@      +@.                        .@@            :##########:              
                                @@@          -@+                        @@      #@.                         @@        %#####%#####@              
                              @@                .@%                        @@      @@                          @@    .######@#####@              
                           @@                      .@@          .             @@ @@.                              @@.@######@#####@              
                        @@                             @@+@@=+@%=====  @-     @@                                    -#######@#####@   @          
                     @@                                   @@=+=+===*==*=*++@@                                       -#######@#####@ @#@+:        
                  @@                                         @@==%==+**@@.                        @=                -#######@#####@*==%*=@.      
               @@                                               @@==@@                         @@+#+*@@             =#######@#####@@@   @@       
            @@                                                                              @@++++@+++++@@          +#######@###@-         @@.   
         @@                                                                             -@%++++++@@@+++++++@@       ########@@                :@@
         -%@@.                                                                       %@*++++++@@     @@+++++++@@.   @####%@                      
          @+++%@-                                                                 @@+++++++@@           @@*++++++#@=@#@=                         
          @++++++*@@                                                             @@+++++@@                 .@@++++*@*                            
           @@++++++++@@                                                             @@@                        @@.                               
              #@#+++++++@@.                                                            @@                      .@+@@                             
@@                @@+++++++%@-                                                            @@=*@@%@**           .@++++@@                          
   @@                @@*++++++*@@                                                            @@===++            @@++++++@@.                      
      @@                :@@+++++++@@                                                            @@=-               @@++++++%@.                   
         @@                 @@+++++++@@                                                         .@@@                  @@++++++#@=                
            @@.                @@#++++++%@-                                                  *@#+++@                     @@++++++*@#             
               *@:                .@@++++++*@@                                            @@+++++++@                        @@+++++++@@          
                  -@+                 @@+++++++@@                                      @@++++++%@=                             @@+++++++@@       
                     .@%                 -@@++++++@@.                              -. @+++++@@                                    @@+++++++@@    
                         @@                  @@++++++%@-                        +      @@@-                                          *@*++++++@@@
                            @@                  @@#+++++*@@                 #           =@                                              +@*++++@+
                               @@                  .@@++++++@@           @@+%@            @                                                -@#+@+
                                  @@.                  @@++++++@@     @@++++++@            @                                                  .@+
                                     %@.                  -@%+++++%@@++++++++++@            @                                                    
                                        =@=                  .@@++++*+++@@#=#+++@.           @*                                                  
                                           .@%                   @@**@@    -%++++@%           -@                                                 
