                                                                           .#######@#####@                                                       
                                                                           .#######@#####@=-                                                     
                                                                           :#######@#####@%=@@                                                   
                                                                           -#######@#####@%==@@                                                  
                                                                           =#######@#####@=%==%@:                                                
                                                                           ########@#%@    *@+==#@                                               
                                                                           @######@*          :@%@                                               
                                              #@==@.                       @###@                 .@@                                             
                                              @*#%=                        @#                        @@                                          
                                             @@====@#                      :#.@=                        @@.                                      
                                            @==+====@-                     :#   -@:                        @@.                      @@@#         
                                          @==*#%@@===#=                    :@      *@.                        +@=                +##@####@       
                                         @==@@.    %@=@                       @@      %@.                        .@@            @###@#####@      
                                        -@@           +@-                        @@      @@                          @@        %####@######.     
                                      @@.                :@#                        @@      @@                          @@    @#####%######.     
                                   @@                       .@@         --             @@@@.                               @@+######%######.     
                                @@                              @@=@*=@@**===@ @@@    @@                                     @#############.  @@ 
                             @@                                    @@=+===*=+=++#==@%                                        @#############..@==@
                          @@                                          @@==+=*==@@:                        @@:                @#############@*=@*=
                       @@                                                @@=@@                         @@++@+*@*             @#############@@   .
                    @@                                                                             .@@+++++%+++++@@          @##########@=       
 -=@             =@                                                                             :@%++++++@@@@+++++++@@       @#######@.          
 @=@              @+@@                                                                       *@*++++++@@      @@+++++++@@    @###%@              
=+=@              @++++%@:                                                                @@+++++++@@            @@*++++++%@:@@+                 
=*=@              @+++++++*@%                                                            .@@++++@@                  -@%+++*@%                    
@=%@.               @@++++++++@@                                                            .@@                         @@                       
@.   =@-               #@*+++++++@@                                                             @@                      @++@@                    
        .@#               .@@+++++++@@:                                                            @@@@@==#@            @+++++@@                 
           .@@                @@+++++++*@%                                                            @@=%=@            .@@++++++@@.             
               @@                -@@+++++++@@                                                            @@@               .@@++++++@@.          
                  @@                 @@+++++++@@                                                        .@@@                   @@++++++%@:       
                     @@.                %@*++++++@@:                                                 =@#+++@                      @@++++++#@=    
                        @@.                .@@++++++*@@                                           @@+++++++@                         @@++++++*@# 
                           +@-                 @@+++++++@@                                     @@++++++%@+                              @@++++++*
                              :@#                 =@@++++++@@                              :.  @++++@@                                     @@++++
                                 .@@                  @@++++++@@:                       +       @@-                                           @@+
                                     @@                  @@*+++++*@%                @            @.                                              
                                        @@                  .@@++++++@@          @@++@            @#                                             
                                           @@                   @@++++++@@    @@++++++@*           :@                                            
                                              @@.                  +@%+++++@@+++++++@++*@            @                                           
                                                 *@:                   @@+++@+++%@# @++++@            @                                          
                                                    :@+                   @@@@@     @+++++@            @.                                        
                                                       .@@                          @++++++@:           @%                                       
                                                           @@                       @+++++++#@           .@                                      
