                                                            -@%##@                                                                               
                                                          @###%####@                                                                             
                                                         @####%#####:                                                                            
                                                        @#####@#####*                                                                            
                                                       @######@######                                                                            
                                                       #######@#####@                                                                            
                                                       #######@#####@=*                                                                          
                                                      .#######@#####@=#=                                                                         
                                                      .#######@#####@==@@@                                                                       
                                                      .#######@#####@+==@@                                                                       
                                                      :#######@##%@  .@@=#=@                                                                     
                                                      =#######@.         @@=@                                                                    
                          @@@+                        =###%@                @@                                                                   
                         :====*                       +@-                      @@.                                                               
                        @==@%+=@                       @@@                        %@:                                                            
                       @+#+===#@                       @   @@                        :@#                       ...                               
                     .#=**=@*=#@+                      @      @@                        .@@                  @#@####*                            
                     @==@@   .@%=@                      @@.     .@*                         @@             @###@#####@                          @
                    =@@         .@@                        @@.     :@-                         @@         @####%######:                        @ 
                  @@                @@                        @@.     =@.                         @@.    @#####%######-                      .@  
               @@                      @@                        #@. @@.                             *@- #############-                     @*   
            @@                            @@@@*=+@@+#=%=@  .      @@                                    @#############-   :                @     
         @@                                  @@+===+=%@#==#=*@+@@                                       @#############- @++@             :@      
      @@                                        #@+=+===+==@@.                        +                 @#############@=====@.          @:       
   @@                                              -@*==@@                         @@+@+@@              @#############*@@  @@@         @         
@@                                                    .                        .@@++++@++++@@           @#######%###@-        %@=    %@          
                                                                            -@#++++++@@+++++++@@.       @#######%@               .@@@.           
:                                                                        @@*++++++@@    @@*++++++#@=    @####%@                      *           
+*@%                                                                  @@+++++++@@          =@%++++++*@@ @#@-                            * .      
+++++@@                                                             @@++++++@@                 @@+++++#@+                                  ..    
*+++++++@@                                                             @@@@                       @@@.                                         .#
 -@@+++++++@@:                                                            @@                       @+@@.                                         
     @@+++++++*@%                                                            @@.@@=+@@%            @++++@@.                                      
        @@#+++++++@@                                                            @@==+*@            @@++++++#@-                                   
           .@@+++++++@@.                                                           +@+@               @@++++++*@*                                
               @@+++++++@@:                                                         .@@                  @@++++++*@@                             
@-                -@@++++++*@%                                                   #@*++@                     @@+++++++@@                        :@
  :@#                 @@+++++++@@                                             @@++++++@                        %@*++++++@@                  +@#++
     .@@                 @@*++++++@@                                       @@++++++%@=                            *@*++++++@@            @@*+++++
         @@                 .@@++++++@@:                               :.-@+++++@@                                   =@#++++++@@.     @@+++++++@@
            @@                  @@++++++*@@                         +      @@@-                                         :@#++++++@@@@+++++++@@   
               @@                  =@%++++++@@                              @                                              .@%+++++#+++++@@      
                  %@.                 .@@++++++@@            @@+@            @.                                               .@@++#+*@@         
                     +@:                  @@*+++++@@:     @@+++++@            @*                                                  @@=            
