                                                                                                                                                 
                                                                                                                                                 
                                                                                                                                                 
                                                -#-                                                                                              
                                             %##@####=                                                                                           
                                            @###@#####*                                                                                         .
                                          %#####@#####@                                                                                       @##
                                         .######@#####@                                                                                      ####
                                         @######@#####@                                                                                    .#####
                                         #######@#####@@.                                                                                  @#####
                                         #######@#####@=@@                                                                                 @#####
                                         #######@#####@%==%#                                                                               @#####
                                         #######@#####@=*==@                                                                               @#####
                                         #######@####@@@=%==*@                                                                             @#####
                                        .#######@#@      *@+*+=:                                                                           @#####
                                        .#####@@            :@@                                                                           @  .@##
           .====@                       .##@.                  .@@                                                                      .@       
          -@===#@                       .@+                        @@                                                                  @#        
          @===@==@                       @ -@:                        @@                                                              @          
         @+==#+===@.                     @    +@.                        @@.                    @@##@*                              :@           
       @=%=+@@@@*=+@                     @@      @@.                        +@=               @##%#####-                           @:            
      @==@@      @@#                        @@      @@                         .@@           %##########                          @              
     .@@            +@-                        @@      @@                          @@       ############@                       #@               
  .@%                  :@*                        @@     @@                           @@   @############@                      @                 
@*                        .@@    -   @@@ .#          @@@                                 @@#############@                    .@                 *
                              @@=+=+#=@===+@@=@ =@@@:                                     @#############@  @=@              @@                 @+
                                 @@=++=@==#=+==@@                                         @#############@@=+==@            @                 -@++
                                    @@=====+@@                        :@@@:               @#######%#####@==@@#=+         :@                 @++++
                                       @@@.                        #@*++@++*@#            @#######@#####@-     @@       @-                .@+++++
                                                                @@++++++@++++++@@         @#######@#%@            @@.  @                 @*++++++
                                                             @@++++++%@..@@+++++++@@      @######@@                  -@                .@++++++++
                                                         .@@++++++@@.       @@+++++++@@   @###@.                        .-            @*+++++++++
                                                      :@%++++++@@.             @@*++++++%@@@                                @        @+++++++++++
                                                       .@@++@@.                   :@%++@@                                      :   @#+++++#@++@@ 
                                                           @@                        @@@                                           @@++@=+==@    
@                                                             @@        @            @+++@@                                           @@@#==-    
++@@:                                                            @@+=#==#            @++++++@@                                           :@@-    
+++++*@@                                                            @@%=+             .@@++++++@@                                        .@%@    
@@+++++++@@                                                            @@                .@@++++++@@                                  +@#++*@    
   @@+++++++@@                                                       @@+@                   .@@++++++@@.                           @@*+++++**    
      #@#++++++%@:                                                @@++++@.                      @@++++++#@-                     @@+++++++*@#     
         .@@++++++*@%                                         :@@++++++@@                          @@++++++*@*               @@+++++++%@:        
             @@+++++++@@                                   *@*+++++*@@                                @@+++++++@@        .@@+++++++@@.           
                -@@++++++@@                            .-   @*++@@.                                      @@+++++++@@  :@%+++++++@@               
