                                                                 @####@#####-                                                                    
                                                                @#####@#####%                                                                    
                                                               @######@#####%                                                                    
                                                               #######@#####@                                                                    
                                                               #######@#####@=*                                                                  
                                                              .#######@#####@=*=                                                                 
                                                              .#######@#####@==@@@                                                               
                                                              .#######@#####@+==@@                                                               
                                                              :#######@##@@  .@@=#=@.                                                            
                                                              -#######@.         @@=@                                                            
                                  @@@#                        =###%@                @@                                                           
                                 .====*                       =@-                      @@.                                                       
                                @==@#+=@                       @@@                        +@-                                                    
                               @**====#@                       @   @@                        .@@                       .:.                       
                             .#=#*=@#=%@=                      @      @@                        .@@                  @#@####%                    
                             @==@@   .@@=@                      @@.      @%                         @@             @###@#####@                   
                            =@@          @@                        @@.     .@+                         @@         @####%######-                  
                          @@                @@                        #@.     -@:                         %@.    @#####%######=                  
                       @@                      @@                        +@: @@.                             =@= #############=                  
                    @@                            @@@%#==@@+#=#=@  .      @@                                    @#############=   -              
                 @@                                  %@*=+=+=#%*==#=*@*@#                                       @#############= @*+@             
              @@                                        +@+=====+==@@.                        *                 @#############@=====@:          @
           @@                                              :@#==@@                         @@+@+@@              @#############*@@  @@@         @ 
        @@                                                                             .@@++++@++++@@.          @#######%###@:        +@*    #@  
     @@                                                                             =@#++++++@@+++++++@@.       @#######%@                @@@.   
     @%@=                                                                        @@*++++++@@    @@*++++++#@*    @####%@                      %   
     @+++*@@                                                                  @@+++++++@@          :@@+++++++@@ @#@-                            +
     @+++++++@@                                                             @@++++++@@                 @@+++++#@=                                
      @@*+++++++@@.                                                            @@@%                       @@@.                                   
         :@@+++++++%@-                                                            @@.                      @+@@.                                 
             @@+++++++*@@                                                            @@.@@*+@@#            @++++%@:                              
                *@#+++++++@@                                                            *@+=+#%            @@++++++#@=                           
 @@.                @@+++++++@@.                                                           -@*%               @@++++++*@%                        
    %@:                @@*++++++%@-                                                         .@@                  @@+++++++@@                     
       -@+                :@@++++++*@@                                                   %@*++@                     %@*++++++@@                  
          .@@                 @@+++++++@@                                             @@++++++@                        #@*++++++@@               
             .@@                 %@#++++++@@.                                     .@@++++++@@=                            +@*++++++@@            
                 @@                 .@@++++++%@-                               -.:@++++*@@                                   -@#++++++@@.     @@+
                    @@                  @@*+++++*@@                         +      @@@:                                         .@%++++++@@@@++++
                       @@.                 :@@++++++@@                              @                                              .@@+++++%+++++
                          #@.                  @@++++++@@            @@+@            @.                                                @@++%+*@@ 
                             =@=                  @@#+++++%@-     @@+++++@.           @%                                                  @@-    
                                .@@                  .@@+++++*@@@+++++++++@#           .@                                                        
                                   .@@                   @@*+++@++++%@#@+++*@            @                                                       
