                                                               -#########%                                                                       
                                                              @###########                                                                       
                                                             @############                                                                       
                                                            .#############.                                                                      
                                                            %#############@=                                                                     
                                                            @#############@=@-                                                                   
                                                            @##############===@                                                                  
                                                            @#############@=+==@                                                                 
                                                            @#######%####@@@==#*@.                                                               
                                                            @#######%#@      @@=@%@                                                              
                                                            @#####@*            @@#                                                              
                               @===%:                       @##@                   @@.                                                           
                              @@%==@.                       @@                        @@.                                                        
                              %%=+===:                      @. @@                        =@+                                                     
                            .*==%#*==#@                     @.    @@                        .@@                     @@#%@                        
                           @=*=+@*@#=@=@                    %@      .@%                         @@                @##@####@                      
                          @=+@+     .@@@                       @@.     .@*                         @@           %####@#####@                     
                         @@-            @@                        @@.     :@-                         @@.      %#####@######                     
                      =@-                  @@                        #@.    .@%                          %@:   ######@######                     
                   =@:                        @@  . .    @@. :          +@@+                                -@@######@######                     
                +@:                              @@=@=@==*==%=@@@*% - @@.                                     %######@######  -%@:              @
             #@.                                    @@==@+%=%%%=*==@@                                         #######@######=@*==@.           .@ 
          %@.                                          =@+==@==*@+                        +@@@                #######%######=@*@@==@         @#  
       %@.                                                .@@@.                        @@*++*++@@             ##############@.    @@.       @    
    @@.                                                                             @@++++++++++++@@.         ##########@@           :@@  :@     
  @@.                                                                            @@++++++@@ @@+++++++%@:      #######@:                  @:      
   @+#@*                                                                     :@@++++++@@       #@#++++++*@#   ####@                         @    
   @+++++@@                                                               #@*++++++@@             .@@+++++++@@%@                               :.
   @++++++++@@                                                             @@+++@@                    @@+++@@                                    
     %@#+++++++@@.                                                            @@                         @@                                      
        .@@+++++++#@+                                                            @@.       --            @++@@.                                  
            @@*+++++++@@                                                            %@=+**==@            @+++++#@-                               
               :@@+++++++@@                                                            +@+==@             @@++++++*@*                            
@@.                @@+++++++@@.                                                           -@@                @@++++++*@@                         
   *@-                @@#++++++#@+                                                       @@+@                   @@+++++++@@                      
      :@*                .@@+++++++@@                                                .@@++++@                      @@*++++++@@                   
         .@@                 @@*++++++@@                                          +@#++++++@@                         *@*++++++@@                
             @@                 -@@++++++@@.                                   @@++++++#@@                               =@#++++++@@         :@@+
                @@                  @@++++++#@*                            .:   @+++@@                                      :@%++++++@@.  *@*++++
                   @@                  @@*++++++@@                      @        @#                                            .@%++++++%*++++++#
                      @@.                 .@@++++++@@               -@            @.                                              .@@+++*++++@@. 
                         *@:                  @@++++++@@.        :@#++@.           @@                                                 @@*+@@     
                            -@=                  =@%+++++#@+  :@#++++++@%           .@                                                           
                               .@@                   @@++++++@++++++@@++*@            @                                                          
