                                                                            .#######@#####@@                                                     
                                                                            .#######@#####@=@@                                                   
                                                                            :#######@#####@#==@:                                                 
                                                                            -#######@#####@=@==@                                                 
                                                                            -#######@####@@@=@==*@                                               
                                                                            ########@#@      @@===+                                              
                                                                            @#####@+            *@@                                              
                                               @====@                       @##@                   :@*                                           
                                              @#===@%                       *@.                       .@@                                        
                                              @*==#==@                      .# #@.                        @@                                     
                                            .@===+%==+@                     :#    @@                         @@                     @@##@:       
                                           @=*=@@+@@===@                     @#      @@                         @@.               @##@####%      
                                          @=+@=      @@@                       .@@      @@                         +@-          :####@#####%     
                                         +@-            @@.                       .@@      @@                         .@#      :#####@######.    
                                      =@:                  %@.                        @@    .@@                          .@@   @#####%######.    
                                   +@:                        =@= . .-   @@% -.          @@=                                 @@######%######.    
                                *@.                              .@%+=+=%=#===@@%=@ *-@@.                                     @#############. :@=
                             %@.                                    .@@=@==+==*=*==@@                                         @#############*@%*=
                          %@.                                           @@==+==#@=                        +@@@.               @#############=**@@
                       %@.                                                 @@@.                        @@+++@++%@-            @#############@.   
   .@               @@.                                                                             @@++++++#+++++*@@         @#########@%       
  @=@             .@@                                                                            @@++++++@@ -@%+++++++@@      @######@:          
 .==@              @++@@                                                                     :@@++++++@@        @@+++++++@@   @###@              
=%=@@              @+++++@@.                                                              %@*++++++@@              @@+++++++@@@@                 
=@=+@              @#+++++++%@=                                                            -@#++@@                    *@#++@@                    
%==@@@.              .@@+++++++*@@                                                            :@#                        @@%                     
@+     @@.               @@*+++++++@@                                                            .@@       .@            @+++@@                  
          *@-               :@@+++++++@@.                                                           .@@@=+==@            @++++++@@               
             :@#                @@+++++++%@-                                                            @@*=@             +@*++++++@@            
                .@@                *@#++++++*@@                                                            @@                -@#++++++@@         
                    @@                .@@+++++++@@                                                       @@+@                   .@%++++++@@      
                       @@                 @@*++++++@@.                                               .@@++++@                      .@@++++++@@.  
                          @@                 :@@++++++%@-                                         *@*++++++@@                          @@++++++%@
                             @@.                 @@++++++*@@                                   @@++++++#@@                                @@+++++
                                *@:                 #@#++++++@@                            ..   @+++@@                                       @@++
                                   -@+                 .@@++++++@@.                     #        @*                                             @
                                      .@@                  @@++++++%@-              =@.           +@                                             
                                          @@                  -@@+++++*@@        -@#++%@           .@                                            
                                             @@                   @@++++++@@  :@#++++++*@            @                                           
                                                @@                   %@*+++++@++++++@@+++@            @                                          
                                                   @@                   .@@++@++#@@  @++++@.           @=                                        
                                                      @@.                   @@@      @+++++@*           =@                                       
                                                         =@=                         @++++++*@           .@                                      
                                                            :@#                      @++++++++@            @                                     
