                                                                          @#############                                                         
                                                                          @#############=+                                                       
                                                                          @#############=%+@                                                     
                                                                          @#############*=@==-                                                   
                                                                          @#############*#=+=@                                                   
                                                                          @##########@#  @@=#==:                                                 
                                                                          @#######@.        @@==@                                                
                                              @@@                         @###@@               +@-                                               
                                             @===+                        @@.                     .@@                                            
                                            %=%@*=#                       @*@.                       .@@                                         
                                           @+#=%=+@.                      @   %@.                        @@                                      
                                         #===+=@=*==@                     @      @@                         @@                   @#@###@         
                                        .*#=@@   @@==@                     .@#      @@                         @@.             @###@######       
                                       @=@@         @@                        .@@      @@                         =@+         %####@#####@       
                                      @@               @@.                        @@      @@                         .@@     @#####@#####@       
                                   @@                     *@:                       .@@  @@.                             @@ @######@#####@       
                                @@                           -@+@@@+@.@==+@=.        .@@                                    #######@#####%   .   
                             @@                                 .@@=%=%==*%*=@+=@@#@-                                       #######@#####%  =*=@ 
                         .@@                                       .@@==%=@=@%=@@.                                          #######@#####%@@=#=%=
                       @@                                              @@=%=@@                         @@++@@.              #######@#####%=@@ +@*
                    @@                                                    -                        :@%++++++++#@=           #######@####@.       
.+.             .@%                                                                             @@*+++++*@*++++++*@@       .#########@           
=%:              @@@                                                                         @@++++++*@*   .@@+++++++@@    .#####@%              
+==              @+++@@                                                                   @@++++++*@*          @@+++++++@@..##@.                 
==*              @++++++@@.                                                             @*+++++*@+                @@*+++++@@-                    
+=*              :@@+++++++#@*                                                            -@#@=                      -@@@                        
@  @@.               @@++++++++@@                                                            :@#                       @*@%                      
      #@.               #@#+++++++@@                                                            .@@ @=@@@@@            @++++@@                   
         =@=               .@@+++++++@@.                                                            @@==@=@            @*++++++@@                
            :@%                @@*++++++#@*                                                            @@=@              =@*++++++@@             
                @@                -@@+++++++@@                                                          -@@                 :@#++++++@@          
                   @@                 @@+++++++@@                                                    @@*++@                    .@%++++++@@       
                      @@                 %@*++++++@@.                                             @@++++++@                       .@@++++++%@.   
                         @@                 .@@++++++#@+                                      .@@++++++@@:                            @@++++++#@-
                            @@.                 @@+++++++@@                                =.@+++++*@@                                   @@++++++
                               *@:                 =@@++++++@@                         .-     @#@@.                                         @@+++
                                  :@*                  @@++++++@@.                  :          +@                                              @@
                                     .@@                  @@*+++++#@*            @@@@           .@                                               
                                         @@                  .@@++++++@@      @@+++++@            @                                              
                                            @@                   @@++++++@@@@+++++++++@            @                                             
                                               @@                   +@%++++@++++@@*@+++@            @+                                           
                                                  @@.                   @@+@*@@    @++++@*           =@                                          
                                                     #@:                           @+++++*@            @                                         
                                                        -@+                        @+++++++@            @                                        
