                                                              @##@####%                                                                          
                                                            .####@#####@                                                                         
                                                           ######@#####@                                                                         
                                                           ######@#####@                                                                         
                                                          @######@#####@                                                                         
                                                          @######@#####%=@                                                                       
                                                          @######%#####%=%=@                                                                     
                                                          @######%######=%+==                                                                    
                                                          @######%######*==%=                                                                    
                                                          @##########@% .@@=*=@                                                                  
                                                          @#######@.        @@=%%                                                                
                              #@+                         @###%@               @@                                                                
                             @=@=@                        %@:                     @@.                                                            
                            ==+@@=@                       @@@                        %@:                                                         
                           @=@=*#%@                       @   @@                        -@*                                                      
                         @===*=+=#==@                     @      @@                        .@@                  .@#####@                         
                        -#==@@  :@#=@+                     @@      .@*                         @@              @########%                        
                       @=@@        .@@                        @@.     :@=                         @@         .#####%#####@                       
                      @@               @@                        @@.     =@.                         @@.     %#####@#####@                       
                   @@                     @@                        %@.  @@.                            *@- @######@#####@                      @
                @@                           @@ @%@@@ @==@@#         .@@                                   -#######@#####@   .                -@ 
             @@                                 @@=*#*===%=*==+=@@%@=                                      -#######@#####@ ==@=:             @.  
          @@                                       @@==*==*=*==@@.                                         -#######@#####@+@=#++            @    
      .@@                                             =@*==*@@                        .@@*+@@              =#######@#####@=@@ @@=         %@     
   .@@                                                   :=                        :@@+++@++++@@           +#######@####@.       @@-     @       
.@@                                                                             #@*+++++*@+++++++@@.       ########@#@              .@@.@        
=@@.                                                                         @@++++++*@*   @@*++++++%@-    %#####@%                     .        
 @++*@*                                                                   @@++++++*@*         =@#++++++*@% @##@:                           # :   
 @++++++@@                                                             *@++++++*@+               .@@++++++@@-                                 .. 
 @@++++++++@@                                                             @@*@=                      @@@@                                        
    -@%+++++++@@.                                                            @@                       .@@@                                       
       .@@+++++++*@%                                                            @@.-@ @@@@#           .@+++@@.                                   
           @@*+++++++@@                                                            %@==++=+           =@++++++#@:                                
              .@@+++++++@@                                                            *@+=-              @@++++++*@*                             
@.                @@+++++++@@.                                                          -@#                 @@++++++*@@                          
  +@-                =@%++++++*@*                                                    @@*++@                    @@+++++++@@                       
     :@#                .@@+++++++@@                                              @@++++++@                       @@+++++++@@                   %
        .@@                 @@*++++++@@                                       .@@++++++@@-                           *@*++++++@@             @@++
            @@                 .@@++++++@@.                                -.@+++++*@@                                  =@*++++++@@       @@+++++
               @@                  @@++++++*@%                         .=     @+@@.                                        -@#++++++@@.@@+++++++@
                  @@                  +@#++++++@@                   @          @.                                             .@%+++++@++++++@@  
                     @@.                 .@@++++++@@             @@@.           %@                                               .@@++@++*@%     
                        #@:                  @@*+++++@@.      @@++++@%           .@                                                 .@@@:        
                           -@+                  :@@+++++*@#@@++++++++*@            @                                                             
