                                                                                                                                                 
                                                                                                                                                 
                                                    -@###@                                                                                       
                                                  @########@                                                                                     
                                                 @##########                                                                                     
                                                %###########.                                                                                    
                                               @######%#####:                                                                                    
                                              .#######%#####+                                                                                    
                                              :#######%#####%=.                                                                                  
                                              =#######%#####@+@#                                                                                 
                                              +#######@#####@==**@                                                                               
                                              +#######@#####@%==*@                                                                               
                                              ########@##%@  *@+===@                                                                             
                                              @#######@:        .@@=@                                                                           :
                  *@@.                        @###%@                @@                                                                         @:
                 *====:                       @@=                      @@                                                                     @  
                @==@@==-                      -+@%                        @@                                                                *@   
               @+%%===@-                      =+  .@=                        @@.                                                           @.    
             .*==#=@===+#                     =-     -@:                        =@=                  @#@###@.                            .@      
             @+=@@   #@==@                      @@      *@.                        .@@             @###@#####@                          @%       
           -=@@         =@=                        @@      @@                          @@         @####@######                         @         
          @@               .@@                        @@      @@                          @@     @#####@######.                      .@          
       @@                      @@                        @@  @@.                             @@ .######@######.                     @-           
    @@                            @@@@==#@@=@=@=@        .@@                                    @######%######.   .                @             
 @@                                  @@=#=#==@#@==#=#@+@#                                       @#############. %+=@             +@              
                                        @@+=%=*=++=@@.                        :                 @#############@+===+@           @.               
                                           @@=+=@@                         @@+@*@#              @#############=@@ .@@@        .@                 
                                              -                        .@@++++%++++@@           @###########@-        @@.    @@                .@
                                                                    =@#++++++@@+++++++@@        @########@               =@*@                 @#+
                                                                 @@*++++++@@    @@+++++++@@.    @####%@                      .               @+++
                                                              @@+++++++@@          @@*++++++%@: %#@=                            @ .        @%++++
                                                            @@++++++@@                -@%+++++#@*                                  =      @++++++
@@                                                            .@@@%                      .@@@.                                        ..@@+++@#@@
+++@@                                                             @@                       @+@@                                           @@%*=@=
++++++@@:                                                            @@ @@#@@@@            @++++@@                                           :@@@
@@+++++++*@@                                                            @@==#=@            @@++++++@@.                                           
   =@%+++++++@@                                                            @@=@               @@++++++@@.                                     @@+
       @@+++++++@@                                                          .@@                  @@++++++%@:                              .@@++++
          @@*++++++%@:                                                   #@#++@                     @@++++++*@+                        .@%+++++++
             .@@++++++*@#                                             @@++++++@                        @@++++++*@@                  +@#+++++++@@ 
                 @@+++++++@@                                       @@++++++%@*                            @@+++++++@@            @@*++++++*@@    
.@%                 +@%++++++@@                                :.@%+++++@@                                   @@+++++++@@      @@+++++++%@-       
   .@@                  @@++++++@@:                         *     :@@@-                                         @@+++++++@@@@+++++++@@.          
       @@                  @@*+++++*@@                  .           @                                              #@*+++++*+++++@@              
