                                                                                                                                                 
                                                                                                                                                 
                                                    =@@                                                                                          
                                                 *##@####@                                                                                       
                                                @###@#####@                                                                                      
                                              -#####@#####@                                                                                      
                                              ######@#####@                                                                                      
                                             @######@#####@                                                                                     %
                                             @######@#####@@-                                                                                  @#
                                             %######@#####@#@@.                                                                                @#
                                             %######@#####@@===@                                                                               @#
                                             %######@#####@==+=*                                                                               @#
                                             #######@####@#@*@==+@                                                                             @#
                                             #######@#@      .@@@@=*                                                                           @#
                  .                          #####@@             @@                                                                           @. 
                ==*=@                        ##@.                   @@                                                                       @   
              .@===#@                        @@                        @@.                                                                 @@    
              @===#==@                       @ .@@                        %@:                                                             @.     
            .@@==#====#=                     @    .@%                        -@*                    @%###@                              .@       
           @=%==@@+@@=%*                     @@      :@=                        .@@               @########@                           @+        
          @==@@      :@#:                       @@      -@:                         @@           @##########-                         @          
         .@%            .@@                        @@      *@.                         @@       @###########@                       -@           
      .@@                   @@                        @@     @@                           @@   @############@                      @.            
   .@#                         @@  . @.  =#@..@          @@@                                 *@#######%#####@                     @              
:@+                               @@=@=%==*====@@=* =@@@:                                     @#######%#####@  @*@              %@               
                                     @@==%=@==#=+=*@@                                         @#######@#####@@=*#=@            @.                
                                        %@====*=@@                        .@@@@               @#######@#####@==@@@==.        .@                 @
                                           =@@:                        *@*++@+++@@            @#######@#####@-     @@       @*                .@+
                                                                    @@++++++@++++++@@         @#######@#%@            +@*  @                 @#++
                                                                 @@++++++%@. @@+++++++@@.     @######@#                   @                 @++++
                                                              @@++++++%@.       @@*++++++#@=  @###@.                         @            @%+++++
                                                          :@@++++++@@.             :@@++++++*@@@                                =        @+++++++
                                                            @@++@@.                    @@++@@                                       :  @@+++++*@#
@@                                                             @@                        =@@                                           @@#*@==*=@
+++%@:                                                            @@     .  @            %*++@@.                                          :@@=#=@
++++++*@@                                                            @@==%===.           @++++++@@.                                           @@@
+@%+++++++@@                                                            @@===              @@++++++%@:                                       .@@@
    @@+++++++@@.                                                           #@                 @@++++++#@=                                 =@#+++@
       @@*++++++%@-                                                      @@+%:                   @@++++++*@#                           @@*++++++@
          .@@++++++*@@                                                @@++++#*                      @@+++++++@@                     @@+++++++*@% 
              @@+++++++@@                                         :@%++++++@@.                         @@+++++++@@               @@+++++++@@:    
                 +@#++++++@@                                   :@*+++++*@@                                @@*++++++@@         @@+++++++@@        
 @@                 .@@++++++@@:                           .-   %@++@@.                                      *@*++++++@@  :@@+++++++@@           
    @@                  @@*+++++*@@                     @        .@                                             -@#++++++@++++++*@@              
