                                                                                                                                                 
                                                        +@##%@                                                                                   
                                                      @#########                                                                                 
                                                     @#########%                                                                                 
                                                   .############                                                                                 
                                                   @############                                                                                 
                                                  @#############.                                                                                
                                                  @#############==                                                                               
                                                  @#############=@+@                                                                             
                                                  @#############*+%==+                                                                           
                                                  @#############%*=+=%                                                                           
                                                  @##########@@  @@=%==.                                                                         
                                                  @#######@.        @@==@                                                                        
                      *@@                         @###%@               +@-                                                                       
                     @====                        @@-                     .@@                                                                    
                    @=#@+=#                       @*@.                        @@                                                                @
                   @=@+*=+%.                      @   @@.                        @@                                                            @ 
                 =+==#=@=*==@                     @      @@                         @@                   @#@###@                             :@  
                 %@=@@   @@==@                     :@*      @@                         @@.             @###@#####%                          @:   
               @=@@         @@                        .@@      @@                         =@+         %####@#####@                         @     
              @@               @@.                       .@@      @@                         .@@     @#####@#####%                       *@      
           @@                     *@:                        @@  @@.                             @@ *######@#####%                      @.       
        @@                           -@+@@@+@.@=++@=.         @@                                    %######@#####%   .                .@         
     @@                                 .@@=#=%==*@#=%*=@@+@*                                       #######@#####%  +==@             @@          
  @@                                        @@==#=@=@%=@@.                                          #######@#####%@%=*=@+           @            
@                                              @@=@=@@                         @@+*@@.              #######%#####%=@@ *@**        .@             
                                                  +                        .@@++++++++#@=           #######%####@:       .@@     @-              
                                                                        +@#++++++@*++++++*@@        #########@               @@.@                
                                                                     @@*++++++@@   .@@+++++++@@    .#####%@                                     .
                                                                  @@+++++++@@          @@+++++++@@ .##@-                           .:          @*
@@.                                                             @*+++++*@%                @@++++++%@+                                  %      @++
+++#@+                                                            =@#@*                      =@@@.                                        = @#+++
++++++*@@                                                            :@*                       @*@#                                           @@@
%@#+++++++@@                                                            .@@ @-@@@@@            @++++@@                                           
   .@@+++++++@@.                                                            @@==@=@            @*++++++@@                                        
       @@+++++++#@*                                                            @@=@              =@*++++++@@                                     
          =@@+++++++@@                                                          .@@                 -@#++++++@@                               .@@
              @@+++++++@@                                                    #@*++@                    .@%++++++@@                         :@%+++
                 @@*++++++@@.                                             @@++++++@                       .@@++++++@@.                  #@*++++++
 @@                 .@@++++++#@+                                       @@++++++@@+                            @@++++++#@-            @@+++++++*@#
    @@.                 @@+++++++@@                                :.@++++++@@                                   @@++++++*@+      @@+++++++%@:   
       *@:                 =@@++++++@@                          +     @#@@-                                         @@++++++*@@@@+++++++@@.      
          -@*                  @@++++++@@.                  :          =@                                              @@+++++*++++++@@          
             .@@                  @@*+++++#@+            @@%@            @                                                @@++*++*@@             
