                                                                                             @+++@@                @@@  @@==@@=.@*@@@@@          
                                                                                             @*+++++@@                @@=++======+@+             
                                                                                             +@*+++++++@@                @@++=#@:                
                                                                                                =@#+++++++@#                @.                 @@
 @@                                                                                                .@@++++++*@*                            .@@+++
 @@@                                                                                                   @@++++++*@-                      :@%+++++@
@++@                                                .                                                     @@*+++++@@                 #@*+++++@@  
  %@.                                             .=+=@                   :@%@                               +@@@                 @@++++++@@     
     :@#                                         %=@*=*@*              @=@===@-                            =@=                 @@++++++@@        
         @@                                    ++=@@:@@==@*           @**==*==*==                       @@.                .@@+++++*@@           
            @@                              #%=@@.      @@=@@==@    *=====@@@=%=@                    @@.                %@*+++++*@+              
               @@.                         @@@.            *@+=*%+#=*==@@     @@==%==@            @@                 @@++++++%@:                 
@-                =@+                    @@.                  .@@==*@@           .@@*%+==@@=*+=@@                 @@++++++@@.                    
++*@@                .@@              @@                                             @@==%=+@*                .@@++++++@@                        
++++++@@                 @@        @@.                                                  @@:                +@*++++++@@                           
@@+++++++@@                 @@.    @#@*                                                                 @@+++++++@@                              
   @@*++++++@@.                *@-*#%@#                                                              @@+++++++@@                                 
      =@#++++++%@-                .                                                               @@++++++*@#                                    
         .@@++++++*@%                                                                               @@+#@=                                       
             @@+++++++@@                                                                               @@                                        
                @@++++++%@                                                                                @@                                     
                   +@#@-                                                                                     @@                                  
                     @@@                                                                                        @@                               
                     @+++@@=                                                                                      @@                             
                     @+++++++@@                                                                                @@++@                             
                     .@@++++++++@@                                                                         =@%+++++@                             
                         @@++++++++%@*                                                                      :@*++@@                              
                            +@%++++++++@@                                                                      *@.                               
                                @@++++++++@@.                                                                     @@                             
                                   @@++++++++#@%                                                                     @@                          
                                      =@%++++++++@@                                                                   #@@                        
                                          @@++++++++@@.                                                            #@*++@                        
                                             @@*+++++++*@@                                                      @@++++++@                        
                                                -@@++++++++@@                                                @@+++++++@@                         
                                                    @@++++++++@@:                               @@@@.     @@+++++++@@                            
                                                       @@*+++++++*@@                        .@@++%+++*@@@++++++%@=                               
                                                          :@@++++++++@@                  -@%+++++@+++++@++++@@                                   
                                                              @@++++++++%@=           @@*++++++@@.@@#++%+@@                                      
                                                                 @@*++++++++@@     @@+++++++@@        *=                                         
                                                                    :@@++++++++@@@+++++++@@                                                      
                                                                        @@++++++@++++*@%                                                         
                                                                           %@*++@+%@-                                                            
                                                                              .@@.                                                               
                                                                                                                                                 
