                                                                                           @++++@@                .@%=*==#**=@==@@               
                                                                                           @+++++++@@                :@*=====@@                 .
                                                                                             @@+++++++@@                -@@@                 +@#+
                                                                                                @@+++++++@@                               @@+++++
@@                                                                                                 *@*++++++@@                         @@+++++*@+
+@                                                                                                    .@@++++++@@                  .@@+++++%@:   
@@                                              @==@                     @.                              .@@+@@                 =@#+++++@@.      
  @@                                          :@====@                @==@%=@                              @@                 @@*+++++@@          
     @@.                                     @%=+@@==##             %==@=+%=@@                        .@@                 @@++++++@@             
        +@=                               -%==@+    =@#=@.@=@    @=%==@==+===%                     +@=                .@@++++++@@                
           .@@                           +=@=          .@@===%@-@%*==%@-  .@@=@=@@@             @@.                -@#++++++@@                   
               @@                      =@+                 @@==*==@@          @@=====#@ @@@@@@@                 @@*+++++*@@                      
@                 @@.               :@+                       #@*                #@+=@==#@@@                 @@++++++#@=                         
++@@.                #@:         :@+                                                .@@@@                 @@++++++%@.                            
+++++#@-                .@%     @@@                                                                   -@%++++++@@.                               
@@++++++*@@                 @@  @++@@                                                              @@*++++++@@                                   
   @@+++++++@@                 @@=                                                              @@+++++++@@                                      
      @@+++++++@@                                                                               -@*+++@@                                         
         *@*++++++@@.                                                                              =@:                                           
            .@@++++++#@.                                                                              +@.                                        
               .@@++@@                                                                                   *@.                                     
                  @@=                                                                                       %@.                                  
                  @+++@@                                                                                       @@                                
                  @++++++@@.                                                                                 @@*@                                
                  *@++++++++#@+                                                                           @@++++#-                               
                     =@%++++++++@@                                                                       @@++++@@.                               
                         @@++++++++@@.                                                                      @@                                   
                            @@*+++++++*@#                                                                      @%                                
                               -@@++++++++@@                                                                     .@=                             
                                   @@++++++++@@:                                                                    +@                           
                                      @@*+++++++*@@                                                              .@@+@                           
                                         :@@++++++++@@                                                        :@%++++@                           
                                             @@++++++++@@-                                                 :@#++++++%@                           
                                                @@*+++++++*@@                                 *@:       =@#++++++@@.                             
                                                   .@@++++++++@@.                          @@++#++@@.+@*++++++@@                                 
                                                       @@++++++++%@=                    @@+++++*++++@+++++#@+                                    
                                                          @@*++++++++@@             .@@++++++*@@%+++@++@@.                                       
                                                             .@@++++++++@@.      *@#++++++%@-     *@@@                                           
                                                                 @@++++++++#@*@@+++++++@@.                                                       
                                                                    %@#++++++#++++++@@                                                           
                                                                       .@@+++@+++@@                                                              
                                                                           @@@@%                                                                 
                                                                                                                                                 
                                                                                                                                                 
