      @.                @@=*=@==#@===%=%=@@.                                                                     :@@++++++@=                     
      @+@@.                +@*=@=@=#*=@@                                                                      #@*++++++@@                        
      @++++#@-                .@@#=@@                                                                      @@+++++++@@                           
       @@+++++*@#                                         +@@@@@@%#=..                                  @@+++++++@@                              
          @@++++++@@                                   @@==+++++++++++++++++++++*#%@@@@@@@@@@@@@@*:..@@++++++#@+                                 
             @@++++++@@                             @@======*+++++++++++++++++++++++++++++++++++++++#+++++@@.                                    
                @@++++++@@                   :. :@=======*@%    ..-#@@@@@@@@@@@@%**+++++++++++++++++#++@@                                        
                   #@*+++++@@             %  .@=======@@.                                  .-#@@@@@@@@                                           
                      =@#+++++@@.         .@=======@@                                                                                            
                         :@%+++++%@:   :@====%=====@                                                                                             
                            .@@+++++*@===*=========@                                                                                             
                                @@+++@=====%=======@                                                                                             
                                   @@@======@======@                                                                                             
                                     @=============@                                                                                             
                                     @====*===++===@                                                                                             
                                     @====##===*===@                                                                                             
                                     @====@==+=#===@                                                                                             
                                     @====%===+%===@@                                                                                            
                                     =*===*====@.     @@                                                                                         
                                     :%===+=+            @@                                                                                      
                                      @==#                %@@                                                                                    
                                      @                 @+++@                                                                                    
                                      @#@=                @@@                                              @=+*%                    @@           
                                      @+++*@@                :@@                                         .#====@+               @==#+@#          
                                      @+++++++@@                 @@                                     @@=+@@@=+@-            @==*%%=*=@        
                                       .@@+++++++@@                 @@                               -@=+@-     @@=@%@+=:   @=#==@=+@=%==-       
                                           @@+++++++@@.                @@.                          @+@-           *@+=#=@@@=@==@@.   @@@=+*%@   
                                              @@*++++++#@=                -@*                     -@-                 .@@====@@          :@@=%=#=
                                                 -@%++++++*@@                .@@               -@-                        @=                 @@==
                                                     @@+++++++@@                 @@         -@-                                                 @
                                                        @@+++++++@@                 @@     #%@*                                                  
                                                           @@*++++++@@.                *@- @++@@                                                 
                                                              =@#++++++#@-                .@:                                                    
                                                                 .@@++++++*@%                                                                    
                                                                     @@+++++++@@                                                                 
                                                                        @@*++++++@@                                                              
                                                                           +@#+@@                                                                
                                                                             #@@                                                                 
                                                                             -#++%@=                                                             
                                                                             :@++++++@@                                                          
                                                                              @@++++++++@@                                                       
                                                                                 @@++++++++#@+                                                   
                                                                                    +@%++++++++@@                                                
                                                                                        @@++++++++@@.                                            
