               @######@@.:@*                           @                                                                          .@.            
               @###@@       .@@         .   .          @-                                                                      =@#+#+            
               @@@              @@ @*+=#@=+=#@*=-@@-@@                                                                      @@*++++*@            
               @@@                 @@===*=+=%@#=+@@                                                                      @@+++++++@@             
               @+++@@.                %@==#==@@:                                                                     .@@++++++*@%                
               @@+++++@@.                -@@                                                                      :@@++++++%@:                   
                 .@@+++++#@=                                      @@=+++++**%@@@@@@@@@@@@@@%+-.                *@*++++++@@.                      
                     @@+++++*@%                               :@%====*+++++++++++++++++++++++++++++++++++*#%@@+++++++@@                          
                        @@++++++@@                      =  @@=======@@@@@@@@@%**++++++++++++++++++++++++++++++++++@@                             
                           @@++++++@@                =  @%=======@@                     .:#@@@@@@@@@@@@%#+++++*@%                                
                              @@++++++@@             @+=+====+@#                                                                                 
                                 @@*+++++@@       @+====%===@                                                                                    
                                    +@*+++++@@.@+===%===*===@                                                                                    
                                       -@#++++@=======%=#===@                                                                                    
                                          .@%+@====*===@%===@                                                                                    
                                             .@====@====%===@                                                                                    
                                              @====@=+==@===@                                                                                    
                                              %====%==+=@===@                                                                                    
                                              ++===*===+%===@                                                                                    
                                              :@===+#===%===@                                                                                    
                                               @=====%==*=%  :@*                                                                                 
                                               @=======@        .@@                                                                              
                                               @====*               @@                                                                           
                                               @=-               .@@+@                                                                           
                                               @@                 @@+@                                               @@#                         
                                               @++@@:                @@.                                            @+@+@                 =@#==+ 
                                               @+++++*@#                -@*                                       @**=@=*=@             -*=#=*==%
                                               -@#+++++++@@                 @@                                 .@%=@@  .@@==%  +@     @@=@==%+*=%
                                                  .@@+++++++@@                 @@                            +%=@@         @@==#*@   @==@==@@ @@=
                                                      @@+++++++@@.                @@.                       @@@               %@*===#==+@%       
                                                         @@+++++++%@:                +@-                  @@                     :@@@@.          
                                                            +@#++++++*@*                .@%            @@                                        
                                                               .@@+++++++@@                 @@      .@.                                          
                                                                   @@+++++++@@                 @@   =#+#@:                                       
                                                                      @@+++++++@@.                @@@@@.                                         
                                                                         *@#++++++%@:                                                            
                                                                            .@@++++++*@*                                                         
                                                                                @@+++++++@@                                                      
                                                                                   @@++++@@                                                      
                                                                                      #@.                                                        
                                                                                      .@+@@                                                      
                                                                                       @++++%@-                                                  
                                                                                       @+++++++*@@                                               
                                                                                        .@@++++++++@@.                                           
