==@                                                                                                  @=@@                :@%++++++%@-            
==@                                                                                                  @@-                @@+++++@@.              @
==@                                                                                                  @++#@.               .@@@  @@=+@@@.@@+@@@@  
==@                                                                                                  @+++++%@.               .@%=@==@=@+==@#     
==@@                                                                                                 @@+++++++@@.               .@*=%=*@=        
     %@.                                                                                                @@+++++++@@                -@.           
        =@-                                                                                                @@*++++++@@                           
         @@@                                                                                                  =@#++++++@@                       .
       @@++@                                                                                                     .@@++++++@.                 *@#+
          @@                                              @=@=@                   .@@-                               @@@@                 @@+++++
             @@                                         .*=#@=+@               @=*====                             :@#                 @@++++++@@
                %@.                                    @*=@@@@==%@            @#+*#*=*==                        @@:                .@@++++++@@   
#@+                -@*                              *@=%@.     :@%@@@==@   -+===+=@@*=+=@                    @@.                =@#+++++*@%      
++++@@                .@@                          @%@.            @@==##@@=@==@@.   .@@=%%=*.            @@                 @@++++++#@=         
+++++++@@                 @@                     %@.                  @@===+@@           @@==+@=+@@=@*=@@                 @@++++++@@.            
 @@+++++++@@                 @@.              #@.                        +.                 +@#=@*==@@                .@@++++++@@.               
    @@*++++++@@.                +@=        %@.                                                 .@@-                =@%++++++@@                   
       =@#++++++#@+                .@@    .@@@                                                                  @@*++++++@@                      
          .@@++++++*@@                 @@ @+#@@                                                              @@+++++++@@                         
              @@+++++++@@                 @.                                                              @@++++++*@@                            
                 @@*++++++@@                                                                               :@#+*@+                               
                    +@#++++++@@.                                                                              -@:                                
                       .@@++++++%@                                                                               =@.                             
                           @@*@=                                                                                    +@.                          
                            .@@#                                                                                       %@.                       
                             @+++@@                                                                                       @@                     
                             @++++++@@.                                                                                @@++@                     
                             @@*+++++++*@@                                                                         :@@+++++@                     
                                :@@++++++++@@                                                                       @@+++@@                      
                                    @@++++++++@@:                                                                      @@                        
                                       %@*+++++++*@@                                                                     .@@                     
                                          .@@++++++++@@                                                                     .@-                  
                                              @@++++++++@@=                                                                   +@=                
                                                 #@*++++++++@@                                                             #@*+*@                
                                                    .@@++++++++@@.                                                      #@*+++++@                
                                                        @@++++++++%@*                                                %@+++++++@@.                
                                                           *@#++++++++@@                                @@@*      @@+++++++@@                    
                                                              .@@++++++++@@.                         @@++@+++@@@@++++++#@+                       
                                                                  @@++++++++#@%                  .@@+++++@+++++*++++@@.                          
                                                                     +@#++++++++@@            #@*++++++%@@@@+++++@@                              
                                                                        .@@++++++++@@.     @@+++++++@@.      .@%                                 
                                                                            @@++++++++*@@@+++++++@@                                              
                                                                               =@#++++++#++++*@@                                                 
                                                                                  .@@+++*+#@+                                                    
