             @####%@-    @@.                         @                                                                         @@@.              
             @#@@.          +@=  @.@@.@@@@@ @@  .  @@.                                                                     .@@+++%-              
             @*                .@@=*+==*##==@=%=@@                                                                      *@*++++++@@              
             @+*@@                 @@===#=@==@@                                                                      @@+++++++@@                 
             @+++++@@                 @@=#@=                                                                      @@++++++*@@                    
              %@*+++++@@                                         @@@@@@@@@@@*-:                               .@@++++++#@+                       
                 +@*+++++@@                                   @@===++++++++++++++++++++++**%@@@@@@@@@@@@@@%*@%++++++@@.                          
                    -@#+++++@@.                           .@@======#+++++++++++++++++++++++++++++++++++++++*+++++@@                              
                       .@@+++++%@-                  *  *@=======@@:        :=@@@@@@@@@@@@@#*+++++++++++++++*++@@                                 
                          .@@+++++*@*           .-  +@=======@@                                     ..+%@@@@@                                    
                              @@++++++@@         +%=======@@                                                                                     
                                 @@++++++@@   *@====+=====@                                                                                      
                                    @@++++++@===@====*====@                                                                                      
                                       @@+++@=====%===+===@                                                                                      
                                          @@@======*==*===@                                                                                      
                                            @====*==#=#===@                                                                                      
                                            @====%===#%===@                                                                                      
                                            @====@====@===@                                                                                      
                                            #+===#====@===@                                                                                      
                                            -*===+====%===@@                                                                                     
                                            .@===*====%      @@.                                                                                 
                                             @=====%            *@:                                                                              
                                             @==@                @@@                                                                             
                                             @                 @%++@                                                                             
                                             @+@@                 @@                                              @=#=@                   .@@:   
                                             @++++@@                 @@                                         .+=#%=*@               @=*===+   
                                             @+++++++@@.                @@.                                    @*=@@@@==%@            @*++%*=#=* 
                                               @@+++++++#@=                =@=                              #@=@@.     -@#@@@==@   ++===+=@@+===@
                                                  +@#++++++*@@                .@@                          @@@.           .@@==**@%=@==@@    .@@=
                                                     .@@+++++++@@                 @@                     @@.                  @@===+@@           
                                                         @@+++++++@@                 @@               %@.                        *.              
                                                            @@+++++++@@.                #@:        %@.                                           
                                                               +@*++++++#@-                .@@    :%@@                                           
                                                                  .@@++++++*@@                 @@ @+#@@                                          
                                                                      @@+++++++@@                 @                                              
                                                                         @@+++++++@@                                                             
                                                                            #@*++++++@@.                                                         
                                                                               .@@++++++@@                                                       
                                                                                   @@*@-                                                         
                                                                                    -@@+                                                         
                                                                                    .@+++@@                                                      
                                                                                     @++++++@@.                                                  
                                                                                     @@*+++++++#@%                                               
                                                                                        -@@++++++++@@                                            
