+++#@=                 .                        *@@+:.                                        @@++++++*@%                             %*+++++++++
@+++++*@%                                    @@==@++++++++++++++*#%@@@@@@@@@@@@@@#=:.     .@@++++++%@-                                #@+++++++++
  @@++++++@@                             .@@=====@++++++++++++++++++++++++++++++++++++++++#+++++@@.                                      @@++++++
     @@++++++@@                    :% -@=======*@+ -+@@@@@@@@@@@@%**++++++++++++++++++++++%++@@                                             @@+++
        @@++++++@@             .%  =@=======@@.                             .:#@@@@@@@@@@@@@                                                   %@
           #@*+++++@@.         --@==%====@@                                                                                                      
              =@#+++++@@.    =@#===@%===@                                                                                                        
                 :@%+++++#@@===@====#===@                                                                                                  @%+  .
                    .@@+++@====@=@==*===@                                                                                                  ====%=
                        @@@====#==@=+===@                                                                                                  -==*==
                          +*==*+====+===@                                                                                                  -==@@ 
                          .@====+===+===@                                                                                                  @@    
                          .@=====*======@                                                                                                  @++@@ 
                           @============@                                                                                                  @*++++
                           @============@%                                                                                                 ##++++
                           @====+====+    .@@                                                                                                %@*+
                           @======*           @@                                                                                                .
                           @===%                @@                                                                                               
                           @@                @@++@                                                                                               
                           @%@:                @@@.                                             .#=*@                    .=                      
                           @*++*@*                =@=                                          @##+=%.               .@=+%%=:                    
                           =#++++++@@                .@@                                      @%@%@@=#%.            .*=*#==+#@.                  
                            .@@+++++++@@                 @@                                @@=@@.    @@==..@=@    @=#==@*==@@=@                  
                                @@+++++++@@.                @@.                          ==#@.          @@==@+@#+@=%==@@.  @@===@@@              
                                   @@+++++++@@.                #@-                      @@.                :@@=====@@         =@%=@===@. @@@#@@@ 
                                      *@#++++++*@*                .@@                *@.                       @@-                @@===*=+=@@    
                                         .@@+++++++@@                 @@          *@.                                                @@@@*       
                                             @@+++++++@@                 @@.     @@:                                                             
                                                @@+++++++@@                 %@:  @++@@                                                           
                                                   #@*++++++@@.                :@@.                                                              
                                                      .@@++++++*@#                                                                               
                                                          @@++++++*@@                                                                            
                                                             @@+++++++@@                                                                         
                                                                #@*+*@=                                                                          
                                                                   @@                                                                            
                                                                   @++@@.                                                                        
                                                                   @+++++*@@                                                                     
                                                                   @@++++++++@@                                                                  
                                                                      @@++++++++@@:                                                              
                                                                         %@*+++++++*@@                                                           
                                                                            .@@++++++++@@                                                        
                                                                                @@++++++++%@=                                                    
                                                                                   #@#++++++++@@                                                 
                                                                                      .@@++++++++@@                                              
