++++@@                 @@+==*@=                                                                      @@+++++++@@                          @++++++
@%+++++@@.                =.                        %%*-..                                       .@@++++++*@#                             @++++++
  .@@+++++%@:                                    @@==*+++++++++++++*#%@@@@@@@@@@@@@@%=:.      :@%++++++@@:                                @@+++++
      @@+++++*@+                             .@@=====@++++++++++++++++++++++++++++++++++++++++++++++@@                                      .@@++
         @@+++++*@%                    =. *@=======%@-.+%@@@@@@@@@@@@#*++++++++++++++++++++++++++@@                                             @
            @@++++++@@              +  @@=======@@                              -=@@@@@@@@@@@@@@                                                 
               @@++++++@@           *@==*====@@                                                                                                  
                  @@++++++@@     %%====##===@                                                                                                    
                     %@*+++++@@#===%====%===@                                                                                                  @#
                        +@#+++@====+=@==@===@                                                                                                  @=
                           :@%@====#==@=@===@                                                                                                  @=
                              @===@@====@===@                                                                                                  @=
                              @====%====%===@                                                                                                  @@
                              **===*=*==#===@                                                                                                  @+
                              :#===+====*===@                                                                                                  @+
                              .@===+====+===@:                                                                                                 @+
                               @====*===+*    -@=                                                                                                
                               @======#          .@#                                                                                             
                               @===@                @@                                                                                           
                               @#                @@++@                                                                                           
                               @@@                 @@@                                              -*%@.                    ..                  
                               @+++@@.                @@.                                          @*=@=@                +@=%%+=                 
                               @++++++#@=                =@=                                      ##=@@*=@@             %@=@*=+=@@               
                                #@#++++++*@@                .@@                                @#=@@.   .@@=%..@@-    @=*==%#+=*+=*              
                                   .@@+++++++@@                 @@                           @=@@           @@==*#@:@%=@==@@   @@=#=@@@          
                                       @@+++++++@@                 @@                       @@.                @@======@@         @@==*===@ .@%@*
                                          @@+++++++@@.                %@:                @@.                      :@@.               :@@=#=@===@%
                                             *@*++++++#@=                :@@          @@.                                                @@%@-   
                                                .@@++++++*@@                 @@      @@                                                          
                                                    @@+++++++@@                 @@  ##+*@#                                                       
                                                       @@+++++++@@                 @@@.                                                          
                                                          %@*++++++@@.                                                                           
                                                             .@@++++++#@+                                                                        
                                                                 @@++++++*@@                                                                     
                                                                    @@++*@.                                                                      
                                                                       @@                                                                        
                                                                       @++@@                                                                     
                                                                       @+++++@@-                                                                 
                                                                       @#+++++++*@@                                                              
                                                                         .@@++++++++@@                                                           
                                                                             @@++++++++%@+                                                       
                                                                                +@#++++++++@@                                                    
                                                                                   .@@++++++++@@                                                 
                                                                                       @@++++++++#@#                                             
