  =%*@@                 @@=*=##==+=@@                                                                      .@@++++++@@.                       @++
  :@++++@@                 @@=*=@@                                                                      *@*++++++@@                           @++
   @@++++++@@                 =                        .@@%+-..                                      @@+++++++@@                              @++
      %@*+++++@@                                    #@*=@+++++++++++++++*#%@@@@@@@@@@@@@@%+..     @@+++++++@@                                 @*+
         =@#+++++@@.                             @@=====*++++++++++++++++++++++++++++++++++++++++@+++++*@+                                      =
            .@%+++++%@:                    =  @@=======@@ ..*@@@@@@@@@@@@%#*+++++++++++++++++++++@++@@.                                          
               .@@+++++#@=            =%   @=======%@=                             ..-*@@@@@@@@@@@@                                              
                   @@+++++*@@         : @=======@@                                                                                               
                      @@++++++@@     @====#=====@                                                                                                
                         @@++++++@@=========*===@                                                                                                
                            @@++++@=====+=======%                                                                                                
                               @@+@======*======%                                                                                                
                                  @========%====%                                                                                                
                                  @====%====*===%                                                                                                
                                  @=====@=======%                                                                                                
                                  @=======@=====#                                                                                                
                                  @====#===%====@                                                                                                
                                  @====*+====-    @@.                                                                                            
                                  @====@==.          @@.                                                                                         
                                  @====.               :@@                                                                                       
                                  =#                .@*++@                                                                                       
                                   @@@                .@@@                                              @==@                     @               
                                   @+++@@                 @@                                          .@====@                @+=%@=@             
                                   @++++++@@.                @@.                                     @#==@@==**             @==@=*%=@@           
                                    @@+++++++%@-                #@-                               .%==@@    +@*=@ @*@    @=@==@======%           
                                       %@*++++++*@%                .@@                           *=@%          .@@=+=@@.@%+==#@*  :@@=@=@@@      
                                          :@@+++++++@@                 @@                      -@%                 @@==*==@@          @@=====#@ @
                                              @@+++++++@@                 @@                .@@                       @@@                @@==%==@
                                                 @@+++++++@@.                %@.         .@%                                                .@@@@
                                                    %@*++++++%@:                -@*     @@@                                                      
                                                       :@@++++++*@%                .@@  @++@@                                                    
                                                           @@+++++++@@                 @@#                                                       
                                                              @@+++++++@@                                                                        
                                                                 @@*++++++@@                                                                     
                                                                    :@@++++++%@.                                                                 
                                                                        @@++@@                                                                   
                                                                          @@-                                                                    
                                                                          @++*@@                                                                 
                                                                          @++++++@@                                                              
                                                                          +@++++++++%@=                                                          
                                                                             +@#++++++++@@                                                       
                                                                                .@@++++++++@@.                                                   
                                                                                    @@++++++++#@#                                                
                                                                                       =@%++++++++@@                                             
