         @%@+           .@@  @+*@-#+@=@@@@ .@ =@+                                                                      @@++++@                   
        :@@                 @@=@+#==##=@=@=@@.                                                                     .@@++++++%@                   
        :@++@@                 @@==**%==@@                                                                      +@#++++++@@                      
        .@+++++@@                 @@%@@                                                                      @@*++++++@@                         
          -@#+++++@@.                                       =@@@@@@@@@@@@@@@#+...                         @@+++++++@@                            
             .@@+++++@@.                                 @@===@+++++++++++++++++++++++++++*#%@@@@@@@@@@@@++++++*@#                               
                .@@+++++#@-                           @@=======%#*+++++++++++++++++++++++++++++++++++++@++++%@:                                  
                    @@+++++*@%              =  :. .@=======+@%            .-#@@@@@@@@@@@@%**+++++++++++@+@@.                                     
                       @@++++++@@           #  .@=======@@.                                         .=*@                                         
                          @@++++++@@        .@========@                                                                                          
                             @@++++++@@  .@====%======@                                                                                          
                                @@++++++@=============@                                                                                          
                                   %@*++@====%====%===@                                                                                          
                                      =@@=====%=======@                                                                                          
                                        @======+======@                                                                                          
                                        @=======+=====@                                                                                          
                                        @====*====@===@                                                                                          
                                        @====+=*======@                                                                                          
                                        @====#==*====-@@.                                                                                        
                                        @====%====-      +@-                                                                                     
                                        %====@=.            :@+                                                                                  
                                        +*=*                +@#@                                                                                 
                                        .@                 @@++@                                                :                                
                                         @+@@                 @@                                              @===%                  .@#@%       
                                         @++++@@.                @@.                                        @===%==@.             @=+==@*@       
                                         @+++++++#@=                +@=                                   .@==@*+@**+@.          -+=+=+*=+=@     
                                           #@*++++++*@%                .@@                             .@%=@*      .@@*@===-   @+%=%==@@%=#=@    
                                              .@@+++++++@@                 @@                         ++@*             @@=#@=#=@==@@.     @@=*==@
                                                  @@+++++++@@                 @@                    .@*                   @@===@@            @@==
                                                     @@+++++++@@.                %@:             .@#                         .                  :
                                                        *@*++++++#@-                :@%       .@*                                                
                                                           .@@++++++*@@                 @@    @+@@                                               
                                                              .@@+++++++@@                 @@ @*@@                                               
                                                                  @@+++++++@@                 .                                                  
                                                                     @@*++++++@@.                                                                
                                                                        :@@++++++%@=                                                             
                                                                            @@++++++@+                                                           
                                                                               @@@@                                                              
                                                                                @*@@                                                             
                                                                                @*+++@@                                                          
                                                                                %*++++++@@-                                                      
                                                                                 *@#++++++++@@                                                   
                                                                                    .@@++++++++@@                                                
                                                                                        @@++++++++%@*                                            
