                                                                                                  @@                .@+++++++@@              +@: 
                                                                                                  @++@@                @@#@* :-=@.@@ .@=::%@.    
                                                                                                  @+++++@@                @@=%==#@##*==@@        
*                                                                                                 @++++++++@#                @@==%==@@           
 .@@                                                                                                %@*++++++*@#                @@@              
     @@                                                                                                :@@++++++*@=                              
       @@                                                                                                  @@++++++#@:                        @@*
    @%++@                                                                                                     @@++++++%@                   @@++++
      @@@                                              @=%%+                    @=                               %@*@@.                 @@+++++*@
         +@=                                          @==#=@.               @+=%##+                              @@                 =@%+++++%@:  
            .@@                                     :+==@@@=#@.            @+=@@+=+*@                         @@                 @@*+++++@@.     
                @@                                @==@@     @@=@-@@+-   -+#==+=*@=@==:                     @@                 @@++++++@@         
@@                 @@.                          @=@@           @@==@=@%@=====@@   @@*==%@@             :@%                .@@++++++@@            
+++@@.                #@:                      @@                 =@#====@@.         +@#=@=@=@.%@@@+@@:                :@%++++++@@               
++++++#@+                :@#                @@                        @@                .@@===+%=@@.                @@*++++++@@                  
:@@+++++++@@                .@@          @@                                                 @@@@                 @@++++++*@%                     
    @@+++++++@@                 @@     .@@:                                                                   @@++++++#@=                        
       @@+++++++@@                 @@. @++@@.                                                             :@@++++++%@:                           
          %@*++++++@@.                =@@                                                              @@*++++++@@.                              
             :@%++++++#@=                                                                               @@+++@@                                  
                .@@++++++*@@                                                                               @@                                    
                    @@+++++++@@                                                                               @@                                 
                       @@*+@@                                                                                    @@                              
                         -@@                                                                                       .@@                           
                          @++@@.                                                                                       @@                        
                          @+++++*@%                                                                                 -@@+@                        
                          @@++++++++@@                                                                           @@*++++@                        
                             @@++++++++@@:                                                                      -@*+++#@@                        
                                @@*+++++++*@@                                                                      %@.                           
                                   .@@++++++++@@                                                                      @@                         
                                       @@++++++++%@-                                                                     @@                      
                                          @@*+++++++*@@                                                                     @                    
                                             .@@++++++++@@.                                                              @@+*#                   
                                                 @@++++++++#@=                                                        @@+++++@                   
                                                    @@#++++++++@@                                                 .@@++++++*@@                   
                                                       .@@++++++++@@.                                .@@        @@++++++%@-                      
                                                           @@++++++++#@*                          +@#+@++@@#.@@++++++@@                          
                                                              #@#++++++++@@                    @@+++++@+++++*+++++@@                             
                                                                 .@@++++++++@@.             @@+++++++@@@++++++%@=                                
                                                                     @@++++++++*@%      .@@+++++++@@     .@@@.                                   
                                                                        +@%++++++++@@*@#++++++#@+                                                
                                                                            @@+++++++#+++++@@.                                                   
                                                                               @@++++*++@@                                                       
                                                                                  =@%@@                                                          
