+@@          .%  @*=======@@                                            ..                                                      @@+++++++++@    .
++++@@        @*====@==#+                                                                                                          #@*+++++@@    
@++++++@@  @+=+=*======%-                                                                                                  *@         -@@@.      
  %@*++++##=======@====%-                                                                                                  =*@@@*@+*@@@          
     =@#++@====+===#===%-                                                                                                  =#==*=#@@             
        :@@====*=======@:                                                                                                  =#*=@@                
          @======#=====@:                                                                                                  +@%                @@*
          @=======#====@:                                                                                                 :@@#                @@+
          @===*========@.                                                                                                 .@++*@+                
          @=====*======@.                                                                                                  @+++++*@-             
          @======*====# +@:                                                                                                @@+++++++#@:          
          @===%====%       :@*                                                                                                @@+++++++%@.       
          @====*#             .@@                                                                                                =@#++++++%@.    
          @==+                @@*%                                                                                                  .@@++++++@@  
          %@                 @@+*@                                               #+                                                     @@++++*@@
          :@+@@.                @@                                              *%==.                  @@*%@                               @@=   
           @++++@@:                @@:                                        @=@=*#=@              @=%===%@                            %@.      
           @*++++++*@%                :@%                                  :@@=@@ :@@%=@-  -      *@=@==@====@                       @@.         
             -@%+++++++@@                 @@                             @##@@        @@=%*==    @=**==@@@@=@=@                   @@             
                .@@+++++++@@                 @@                         @@@              @@==#=%====@@      @@====@*.      .   @@                
                    @@+++++++@@.                @@.                   @@                    *@*@@@:            #@#=@===@@==+@#                .@@
                       @@*++++++%@:                =@=             @@                                             .@@===#@:                =@#+++
                          =@%++++++*@#                .@@       @@                                                    @.                @@*++++++
                              @@+++++++@@                 @@    @+@@.                                                                @@++++++*@@ 
                                 @@+++++++@@                 @@ @@@:                                                             .@@++++++*@*    
                                    @@*++++++@@.                                                                               @@++++++%@-       
                                       =@#++++++%@:                                                                               @@@@.          
                                          .@@++++++*@*                                                                              .@#          
                                              @@+++++@@                                                                                .@#       
                                                 @@@.                                                                                     :@+    
                                                  @+@@                                                                                       :@= 
                                                  @++++@@.                                                                                     @@
                                                  @+++++++#@*                                                                              .@@++@
                                                   -@%++++++++@@                                                                        *@*+++++@
                                                       @@++++++++@@.                                                                      @@+*@@ 
                                                          @@*+++++++*@@                                                                      @@  
                                                             :@@++++++++@@                                                                      @
                                                                 @@++++++++@@:                                                                   
                                                                    @@*+++++++*@@                                                                
                                                                       .@@++++++++@@                                                            @
                                                                           @@++++++++%@-                                                     @@++
                                                                              @@*+++++++*@@                                               @@+++++
                                                                                 .@@++++++++@@.                              @@#@@     @@++++++#@
                                                                                     @@++++++++#@+                       :@@+++*+++#@@++++++@@.  
