=====@.                                                                                                 .=#@=@@                 @@++++++*@@      
=====@.                                                                                                 .=@@                .@@++++++#@+         
*====@.                                                                                                 #@@                -@*++++@@.            
=====@.                                                                                                 =%++@@                +@@  @@==@@=:@@@@@@
=====@.                                                                                                 .@+++++@@                @@==@====*==@@  
=====.@@                                                                                                .@#+++++++@@                @@@===@#     
==       @@                                                                                                .@@+++++++@@                @=        
            @@                                                                                                 @@+++++++@@                       
            @@%:                                                                                                  @@+++++++@@                    
          @@*+#:                                                                                                     *@#+++++@@                 -
             -@#                                              ===+                   .@*@.                              .@@@                 @@*+
                 @@                                         @=%=*%%@              @=*===#@                            .@@                 @@+++++
+@@                 @@                                    .%=*@:@@=*@@           @=======@=@                       =@=                .@@++++++@@
++++@@.                @@.                             .@=*@:      @@=@@==#    #===*=*@@=*=#.                   @@.                :@%++++++@@   
+++++++%@-                +@=                         @*@:            :@%==+=@=@==@@     =@#=%==@            @@                 @@*+++++*@*      
 +@#++++++*@#                .@@                    =@:                   @@=#=@@           .@@%+===@@*=%=@@                 @@++++++#@-         
    .@@+++++++@@                 @@              =@-                         :                  @@==%+=@@                 @@++++++@@.            
        @@+++++++@@                 @@        =@-                                                  =@*                :@@++++++@@                
           @@+++++++@@.                %@:    @*@@                                                                 %@*++++++@@                   
              *@#++++++%@:                :@@ @*@@                                                              @@+++++++@@                      
                 .@@++++++*@#                 .                                                              @@+++++++@@                         
                     @@+++++++@@                                                                               @@+*@%                            
                        @@+++++++@@                                                                               @@                             
                           #@*+++++*@                                                                                @@                          
                              .@@@%                                                                                     @@                       
                                @@@.                                                                                       @@                    
                                @+++*@%                                                                                      *@                  
                                @+++++++@@                                                                                @@++@                  
                                 @@++++++++@@:                                                                        .@@+++++@                  
                                    @@*+++++++*@@                                                                      .@%++@@.                  
                                       .@@++++++++@@                                                                      :@-                    
                                           @@++++++++@@-                                                                     *@.                 
                                              %@*+++++++*@@                                                                     @@               
                                                 .@@++++++++@@                                                                   :@@             
                                                     @@++++++++%@+                                                            -@#++@             
                                                        #@#++++++++@@                                                      =@*+++++@             
                                                           .@@++++++++@@.                                               +@*++++++@@.             
                                                               @@++++++++#@#                               @@@@.     #@*++++++@@                 
                                                                  *@#++++++++@@                         @@+++++++@@@*+++++*@%                    
                                                                      @@++++++++@@.                 .@@+++++*+++++@++++@@.                       
                                                                         @@++++++++*@%           +@#++++++#@=@@@++@+@@                           
                                                                            +@%++++++++@@     @@+++++++@@.       =@                              
                                                                                @@++++++++@@@+++++++@@                                           
                                                                                   @@++++++@+++++@@                                              
