+*@*              .   =  @%=======@@           .=#@@@@@@@@@@@@%*+++++++++++++@+#@=                                               @@+++++++++++@  
++++*@@           #   @=======*@+                                        :=%@@.                                                     @@+++++++++@ 
@@++++++@@         @========@.                                                                                                         @@+++++++@
   @@++++++@@   @====%======@                                                                                                   :         %@*@@  
      @@++++++@========#====@                                                                                                  @=@=@ .*=@@@@     
         @@*++@====+====%===@                                                                                                  @=%==%+=@@        
            *@@=====#=======@                                                                                                  @=+=+@*           
              @=======*=====@                                                                                                  @#@:              
              @========*====@                                                                                                  @@-               
              @====@====#===@                                                                                                  @++#@:            
              @====%=@==+===@                                                                                                  @+++++%@.         
              @====@==@=*==%@@.                                                                                                @@+++++++@@       
              #====@====%      *@:                                                                                                @@+++++++@@    
              =#===*=-            -@=                                                                                                @@*++++++@@ 
              .@==.               .@@@                                                                                                  -@%++++++
              .@                 @@++@                                                .                                                     @@+++
               @+@@                 @@                                              @===@                   @#@*                               @@
               @++++@@.                @@                                         @==*@==@.             ===#=#=@                             @@  
               @+++++++%@:                %@:                                    @==@@%@+=*@.           @=@=#@=+=%                        @@     
                 %@*++++++*@%                :@@                              @*=@@      .@@@@#==%   @@*=%==@@%=*=@                   .@@        
                    :@@+++++++@@                 @@                         .%@@             @@=@@=@=+*=+@#     @@=#==@.           -@+           
                        @@+++++++@@                 @@                     @@                   @@===@@.           @@==*===@@=#=%@.              
                           @@+++++++@@.                %@.              @@                         :                  =@@=#%=@@                 @
                              @@*++++++%@:                -@+        @@                                                   @@                 @@++
                                 :@%++++++*@#                .@@    @+@@.                                                                .@@+++++
                                     @@+++++++@@                 @@ @+@@.                                                             -@%++++++@@
                                        @@+++++++@@                 =                                                              :@*++++++@@   
                                           @@*++++++@@.                                                                              .@#+@@      
                                              -@%++++++%@:                                                                              -@-      
                                                 .@@++++++@@                                                                               -@-   
                                                     @@@@                                                                                     +@.
                                                      @*@@                                                                                       
                                                      ##+++@@                                                                                    
                                                      :%++++++@@:                                                                               +
                                                       %@*+++++++*@@                                                                         @@++
                                                          .@@++++++++@@                                                                       @@+
                                                              @@++++++++%@-                                                                      
                                                                 #@#+++++++*@@                                                                   
                                                                    .@@++++++++@@.                                                               
                                                                        @@++++++++%@+                                                            
                                                                           *@#++++++++@@                                                         
                                                                              .@@++++++++@@.                                                     
                                                                                  @@++++++++#@%                                                @@
                                                                                     +@#++++++++@@                               .@@@%      @@+++
