++@@.                       .    @@======@+++++++++++++++++++++++++++++++++++++++++++++%@:                                       +@#++++++++++++#
+++++@@.               .  ....@+======+@@      .:*@@@@@@@@@@@@%#*+++++++++++++++++++@@.                                             .@%++++++++++
.@@+++++#@=            %  .@+======@@.                                   .-*@@@@@@@                                                     @@+++++++
    @@+++++*@@         .@===*===@@                                                                                                         @@++++
       @@++++++@@   .@====@=*===@                                                                                                             @@+
          @@++++++@===*=====#===@                                                                                                  @*% @  @#@@:@*
             @@+++@====+#===%===@                                                                                                  @==@==#=#@:   
                @@@====#=%==@===@                                                                                                  @=+==@@.      
                  @====@===+@===@                                                                                                  @=@@          
                  @====%====%===@                                                                                                  @@.           
                  *+===*#===%===@                                                                                                  @++@@         
                  -#===+==*=#===@                                                                                                  @+++++@@      
                   @=======**===@@                                                                                                 @%+++++++@@   
                   @========+.     @@.                                                                                                @@+++++++@@
                   @======            @@.                                                                                                @@++++++
                   @==*                +@@                                                                                                  @@*++
                   @                 @#++@                                                                                                     :@
                   @+@@                .@@                                              +=@=@                    @@.                             
                   @++++@@                 @@                                          @==@=%@               @==#=+=                             
                   @+++++++@@.                @@.                                    =@=*@@@==@@            @%=@+==%=+                        .@%
                     @@+++++++%@:                *@-                              .@==@+     +@*@@@*=@   .=#==@=@@====@                    +@-   
                        %@*++++++*@%                .@@                          @=@+           .@@==+@@@=%==@@:   .@@=@@+%             @@.      
                           :@@+++++++@@                 @@                     :@+                  @@====@@           @@===#=#@@*@@=@@          
                               @@+++++++@@                 @@               .@+                        @*                 @@+=@%#=@@             
                                  @@+++++++@@.                @@.        .@*                                                 .@@@                
                                     #@*++++++%@:                -@*     @@@                                                                  -@#
                                        :@@++++++*@#                .@@ @++@@                                                              @@*+++
                                            @@+++++++@@                 @-                                                              @@+++++++
                                               @@+++++++@@                                                                               +@*++@@ 
                                                  @@*++++++@@                                                                               #@.  
                                                     -@@++++++%@                                                                               #@
                                                         @@+@@                                                                                   
                                                           @@-                                                                                   
                                                           @+++@@                                                                                
                                                           @++++++@@.                                                                            
                                                           @@++++++++%@+                                                                         
                                                              =@#++++++++@@                                                                      
                                                                 .@@++++++++@@.                                                                  
                                                                     @@*+++++++#@%                                                               
                                                                        =@%++++++++@@                                                            
                                                                            @@++++++++@@.                                                        
                                                                               @@*+++++++*@@                                                     
                                                                                  -@%++++++++@@                                                  
                                                                                      @@++++++++@@:                                              
