                                                                                               #*%@.               .@@++@@  @+      .   .@#      
                                                                                               =#+++@@.               .@@@==#====@=*@*@=         
                                                                                               -%++++++@@                :@+=#=%==@@.            
                                                                                                .@@+++++++@@                =@=@@                
 @@.                                                                                                @@+++++++@@                                 @
    *@                                                                                                 @@*++++++@@                          :@@++
  @@+@.                                                                                                   =@#++++++@@                    @@*+++++
  :@@@.                                              @%@                                                     .@@++*@@                 @@++++++@@ 
     .@@                                            @%=#=                 #@*===*                              +@-                 @@++++++@@    
         @@                                       @=#=@=*==              #===*@+@-                          @@.                .@@+++++*@#       
            @@:                                 @*@@@   @@+==-  @.    *@+*==%=*==+@                      @@                 *@*+++++#@-          
               -@#                            %=@@         .@@=##%+  @==@==@@ =@%=#@@-.               @@                 @@++++++@@.             
@@                 @@                       @@@                @@==#%==+@@        @@=*==@@#   # @+@@@                 @@++++++@@                 
+++@@                 @@                  @@                      @@@@.              @@==#===+=*@+                .@@++++++@@                    
++++++@@                 @@.           @@                                               -@@+@@.                *@#++++++@@                       
@@*++++++@@.                =@=      @@                                                                     @@+++++++@@                          
   -@%++++++*@*                .@@   @++@@                                                               @@++++++*@@                             
      .@@+++++++@@                 @@@@.                                                             .@@++++++*@*                                
          @@+++++++@@                                                                               =@*++++%@:                                   
             @@*++++++@@                                                                               *@@.                                      
                =@#++++++@@.                                                                              *@.                                    
                   .@@+++%@.                                                                                 @@                                  
                       @:                                                                                       @@.                              
                       @+*@@                                                                                       @@                            
                       @+++++@@                                                                                    @@@                           
                       @++++++++@@:                                                                            :@@+++@                           
                         %@*+++++++*@@                                                                       @@++++++@                           
                            .@@++++++++@@.                                                                      @@@%                             
                                @@++++++++%@-                                                                      @@                            
                                   #@#+++++++*@@                                                                     :@-                         
                                      .@@++++++++@@.                                                                    *@.                      
                                          @@++++++++#@+                                                                @@+@                      
                                             +@#++++++++@@                                                          @@++++@                      
                                                 @@++++++++@@.                                                   @@+++++++@                      
                                                    @@++++++++#@%                                             @@+++++++@@                        
                                                       +@%++++++++@@                            .@@++*@@   @@++++++%@=                           
                                                           @@++++++++@@.                     -@%+++*+++++@++++++@@                               
                                                              @@++++++++*@@               @@*++++++@+++++@+++@@                                  
                                                                 =@%++++++++@@         @@+++++++@@   .@@%@@*                                     
                                                                     @@++++++++@@: .@@+++++++@@                                                  
                                                                        @@*+++++++@++++++*@@                                                     
                                                                           -@@++++@+++%@-                                                        
                                                                               @@+@@@.                                                           
                                                                                                                                                 
