*+===@===@                                                                                                  @=+==*==@@                 @@++++++*@
%+===@===@                                                                                                  @=%==@@                :@%++++++%@:  
@==@=%===@                                                                                                  @=@@                %@*++++++@@.     
#===%#===@                                                                                                  @@@                @@+++++@@         
#====#===@                                                                                                  @+++@@                @@@ .@@==@#%-@+
==*==*===@                                                                                                  @++++++@@                @@=+==#=%==%
===*=+==#:@*                                                                                                @@+++++++*@#                @@=%=@@. 
@====@      .@@                                                                                                #@*++++++*@=                @     
==%             @@                                                                                                .@@++++++*@-                   
                @@@                                                                                                   @@++++++#@.                
              @@++@                                                -                                                     @@++++++@:              
.                @@.                                             ==%=@                   *@%@                               #@@+                 
+*@+                =@=                                        :*=@@==@=              @=@===@                             @@.                .@@+
+++++@@                .@@                                   .@==@@:@@==@+           @@%==#==+=.                       @@                 =@#++++
@+++++++@@                 @@                              @*=@@       @@+@@==@   :%==+==@@@=@=@                    @@                 @@++++++%@
  @@+++++++@@                 @@                          @@@             @@==#**+=*==@@     @@==@==*           .@@                 @@++++++@@.  
     @@+++++++@@.                #@-                    @@                   :@@==@@-           -@%=@%==@@=*=+@#                .@@++++++@@      
        *@*++++++#@+                .@@              @@                                             @@==%=#@:                -@%++++++@@         
           .@@++++++*@@                 @@        @@                                                   @@.                @@*++++++@@            
               @@+++++++@@                 @@    .@%@-                                                                 @@+++++++@@               
                  @@+++++++@@                 %@:@*@@=                                                             .@@++++++*@*                  
                     %@*++++++@@.                :                                                               @%++++++#@-                     
                        .@@++++++#@*                                                                               @@+@@.                        
                            @@+++++++@@                                                                               @@                         
                               @@++++++@@                                                                                @@                      
                                  #@%@.                                                                                     @@                   
                                    @@@                                                                                       .@@                
                                    @+++@@:                                                                                      @@              
                                    @++++++*@@                                                                               .@@++@              
                                    .@@++++++++@@                                                                         %@*+++++@              
                                        @@++++++++%@-                                                                      +@*+*@@               
                                           #@#+++++++*@@                                                                      @@                 
                                              .@@++++++++@@                                                                      @@              
                                                  @@++++++++%@+                                                                     @@           
                                                     *@#++++++++@@                                                                   @@@         
                                                        .@@++++++++@@.                                                            @@+++@         
                                                            @@++++++++#@%                                                      @@++++++@         
                                                               +@#++++++++@@                                                @@+++++++@@          
                                                                  .@@++++++++@@.                               @@@@      @@++++++*@%             
                                                                      @@*+++++++*@@                        .@@++@+++*@@@++++++@@.                
                                                                         =@%++++++++@@                  *@*+++++@+++++%++++@@                    
                                                                            .@@++++++++@@:           @@+++++++@@.@@*++**@%                       
                                                                                @@*+++++++*@@     @@+++++++@@        @.                          
                                                                                   :@%++++++++@@@++++++*@@                                       
