===%====#*===@                                                                                                  @+@-@. @=@@@@                 @@+
====+*===#===@                                                                                                  @==+====@@                 @@++++
====*=+==%===@                                                                                                  @=@==@@                .@@++++++#
====%==@=@===@                                                                                                  @=@@                *@#++++++@@. 
====@===@@===@                                                                                                  @@*                @@+++++@@     
====%====@===@                                                                                                  @++*@+                @@@ .@@==@@
#===*====%===@                                                                                                  @+++++*@:                @@=%==@=
@======+=#==+#@.                                                                                                @@+++++++#@.                @@=@=
@===#====%      =@=                                                                                                @@+++++++%@.               .@.
@=====@            .@%                                                                                                #@*++++++@@.               
@==#                @@@                                                                                                  .@@++++++@@             
@                 @@++@                                                .                                                     @@++++++@.          
@+@@                 @@                                              %=@=@                   -@@%                               @@@#             
@++++@@.                @@.                                        .+=%@==@.              @=%===*                             +@-                
@+++++++#@+                +@+                                    @==@@#@#=+@.           @#*+*#====                        @@.                :@@
  +@#++++++*@@                .@@                              @#=@@      .@@%@@==@   -*=====@@@=#=@                    @@                 @@*+++
     .@@+++++++@@                 @@                          @@@             @@==@*@*=%==@@     @@=*#==:            @@                 @@++++++%
         @@+++++++@@                 @@.                    @@.                  %@===#@#           @@==#@==@@=%+=@@                 @@++++++@@. 
            @@+++++++@@.                *@-              @@                         :                  :@@=*#=*@=                :@@++++++@@     
               *@#++++++#@=                .@%        @@.                                                  @@.                #@*++++++@@        
                  .@@++++++*@@                .@@    .@@@.                                                                 @@+++++++@@           
                      @@+++++++@@                 @@ @+%@%                                                              @@++++++*@@              
                         @@+++++++@@                 %                                                               @@++++++*@#                 
                            *@*++++++@@.                                                                              .@@+%@-                    
                               .@@++++++#@=                                                                              .@*                     
                                   @@++++++@@                                                                               .@*                  
                                      @@*@:                                                                                    :@=               
                                       .@@@                                                                                       -@-            
                                        @+++@@.                                                                                      @@          
                                        @++++++%@=                                                                                @@++@          
                                        *@#+++++++*@@                                                                         *@%+++++@          
                                           .@@++++++++@@.                                                                      @@++*@@           
                                               @@++++++++#@+                                                                      @@             
                                                  +@%++++++++@@                                                                      @@          
                                                      @@++++++++@@.                                                                     @@       
                                                         @@++++++++*@#                                                                   @@*     
                                                            =@%++++++++@@                                                             @@+++@     
                                                                @@++++++++@@:                                                      @@++++++@     
                                                                   @@*+++++++*@@                                                @@+++++++@@      
                                                                      -@@++++++++@@                                @@@@      @@++++++*@@         
                                                                          @@++++++++@@-                        .@@++@+++@@@@++++++@@-            
                                                                             @@*+++++++*@@                  =@#+++++@+++++*++++@@                
                                                                                :@@++++++++@@            @@+++++++@@+@@+++**@@                   
                                                                                    @@++++++++%@=     @@+++++++@@        @-                      
