                                                                                            @+++*@-                @@@+=++===@=@%*@@             
                                                                                            @++++++#@:                @@==++==+@%                
                                                                                             @@+++++++%@.                @@*@-                 @@
                                                                                                @@*++++++@@.                                @@+++
.@+                                                                                                -@%++++++@@.                         .@@+++++%
++@                                                                                                    @@++++++@@                    :@%+++++@@. 
@+@                                              @@@:                                                     @@+++@@                 #@*+++++@@     
  @@.                                           @%=+*-                -@%=@=@                              .@@                 @@++++++@@        
     #@:                                      ==@=#+=+=-             @+==@##@*.                         -@+                 @@++++++@@           
        :@#                                 @@=#@.  :@@==@  @*    .@@@=*%=====%                      %@.                .@@++++++@@              
           .@@                            @=%@.        .@@=+*#@  +@=%=%@@..@@=@#@*.               @@.                #@*+++++*@#                 
               @@                       :%@.               @@==+*==+@@        @@====%@@   @ @%@@@                 @@++++++#@-                    
@.                @@.                 *@.                     =@%@+              +@#=@===%#=@@                 @@++++++@@.                       
++%@:                =@*           *@.                                               @@=+@*                .@@++++++@@                           
+++++*@#                .@@      @@                                                                     +@#++++++@@                              
@@+++++++@@                 @@   @++@@                                                               @@+++++++@@                                 
   @@+++++++@@                 @@@@=                                                              @@+++++++@@                                    
      @@*++++++@@.                                                                              .@@++++*@@                                       
         =@%++++++%@:                                                                              .@@+                                          
            .@@++++++*@%                                                                              .@*                                        
                @@+++*@-                                                                                 .@+                                     
                   @@                                                                                       :@-                                  
                   @++@@                                                                                       -@:                               
                   @+++++@@.                                                                                   @@@                               
                   @*+++++++*@@                                                                            .@@+++%-                              
                     :@@++++++++@@                                                                       :@++++++@#                              
                         @@++++++++@@:                                                                      @@@@                                 
                            @@*+++++++*@@                                                                      @@                                
                               .@@++++++++@@                                                                      @@                             
                                   @@++++++++@@-                                                                    .@#                          
                                      #@*++++++++@@                                                                =@*@                          
                                         .@@++++++++@@                                                          +@*+++@                          
                                             @@++++++++%@+                                                   @@*++++++@.                         
                                                *@#++++++++@@                                   .         @@*++++++@@                            
                                                   .@@++++++++@@.                            @@+%+@@.  @@++++++*@@                               
                                                       @@++++++++#@%                     .@@++++#++++%*+++++@@-                                  
                                                          +@#++++++++@@               -@%++++++#*++++@+++@@                                      
                                                             .@@++++++++@@.        @@*++++++@@.   @@@@@@                                         
                                                                 @@++++++++*@@  @@+++++++@@                                                      
                                                                    =@#+++++++#+++++++@@                                                         
                                                                       .@@++++@+++*@@                                                            
                                                                           @@*@#@=                                                               
                                                                                                                                                 
                                                                                                                                                 
