              -#####%@@  +@=                          @-                                                                         @@@             
              :###@@        .@@     .. +-  @         .@#                                                                      @@+++@             
              =@=               @@@*%==#====@+=@@+@@-                                                                      @@++++++@             
              @+@@                 @@===*=+==**@@.                                                                     .@@++++++@@:              
              @++++@@                 @@%===@@                                                                      *@*++++++@@                  
              :@#+++++@@                 +@                        .-.                                           @@*++++++@@                     
                 .@@+++++@@.                                    *@*=@+++++++++++*#%@@@@@@@@@@@@@@%+..         @@+++++++@@                        
                    .@@+++++#@=                              @@=====@++++++++++++++++++++++++++++++++++++++++#+++++*@*                           
                        @@+++++*@#                     @  @@=======@@%@@@@@@@@@@@@#*+++++++++++++++++++++++++%++@@.                              
                           @@++++++@@             .*  .@=======#@+                          ..=#@@@@@@@@@@@@#@@.                                 
                              @@++++++@@          : @==%====@@                                                                                   
                                 @@++++++@@      @*===*%===@                                                                                     
                                    %@*+++++@@@===%+===#===@                                                                                     
                                       *@*+++@====%=+==*===@                                                                                     
                                          -@#@===+#==+=+===@                                                                                     
                                             +*===*====@===@                                                                                     
                                             :@====@=======@                                                                                     
                                             .@=====@======@                                                                                     
                                              @=======@====@                                                                                     
                                              @====*===%===@.                                                                                    
                                              @=====+====-   +@-                                                                                 
                                              @=======.         :@*                                                                              
                                              @====                .@                                                                            
                                              @*                *@*+@                                                                            
                                              @@@                 @@@.                                              @=@.                     .   
                                              @+++@@.                @@.                                          =@#==%                 @@*#==: 
                                              +#+++++#@-                +@-                                      @**=@+=##             .#=*%=+=@@
                                               %@*++++++*@%                .@%                                =%=%@@   .@@==. #@*    @=%==*%==+%=
                                                  .@@+++++++@@                 @@                           :==@%          @@==+@@..@====*@% .@@=
                                                      @@+++++++@@                 @@                       @@@                @@===*==@@         
                                                         @@+++++++@@.                @@:                .@@                      -@@@            
                                                            #@*++++++#@-                :@%          .@%                                         
                                                               :@%++++++*@@                 @@      @@                                           
                                                                   @@+++++++@@                 @@   @++@@                                        
                                                                      @@+++++++@@                 @@@@                                           
                                                                         @@*++++++@@.                                                            
                                                                            :@@++++++%@-                                                         
                                                                                @@++++++*@@                                                      
                                                                                   @@+++@@                                                       
                                                                                      @@                                                         
                                                                                      @++@@                                                      
                                                                                      @+++++@@:                                                  
                                                                                      @*+++++++*@@                                               
                                                                                        .@@++++++++@@                                            
