+++@@                                    @@==@++++++++++++++++**%@@@@@@@@@@@@@@%*:.   #@*++++++@@                                 +@+++++++++++++
*+++++@@                             -@#=====@++++++++++++++++++++++++++++++++++++++++#+++++@@                                       @@*+++++++++
 #@*+++++@@                .   %# @@=======@@.  .:+@@@@@@@@@@@@%#*++++++++++++++++++++%++@@                                             +@#++++++
    =@#+++++@@.            .:  @@=======@@                                .-*@@@@@@@@@@#                                                   .@@+++
       :@%+++++#@-         :@*==@===*@+                                                                                                        @@
          .@@+++++*@*    @+*===+@===@                                                                                                            
              @@++++++@+===@====@===@                                                                                                  %%+ .. #@@
                 @@+++@====@=*==*===@                                                                                                  +===%====@
                    @@@====%==*=*===@                                                                                                  ===@==@@  
                      **===*===#+===@                                                                                                  ===@%     
                      .%===#====%===@                                                                                                  @@        
                      .@============@                                                                                                  @++@@     
                       @======+=====@                                                                                                  @*++++@@  
                       @===#===*====@@                                                                                                 ##+++++++@
                       @====%====%     @@                                                                                                .@@+++++
                       @======@           @@                                                                                                 @@++
                       @===*                @@                                                                                                  @
                       @-                @@++@                                                                                                   
                       @*@*                =@@.                                             .=+=@                    -@                          
                       @*+++@@                .@@                                          @=*%=@#               %%=*=%=:                        
                       **++++++@@                 @@                                      %+%@@@==@-            -*=#===%=@.                      
                         @@+++++++@@                 @@                                @+=@@     @@=+=+@=@    @+===+*%=#%=@                     @
                            @@+++++++%@:                #@-                          @=@@           =@#=*=@@@+=#==@@   #@*=*+@@.             @@  
                               *@*++++++*@#                .@@                      @@                  @@====*@*         .@@=@===@*:@@@=#@%     
                                  .@@+++++++@@                 @@                @@                        @@                 @@==**+=*@-        
                                      @@+++++++@@                 @@          @@                                                 *@@@.           
                                         @@+++++++@@.                %@:     @@@                                                                 
                                            %@*++++++%@:                :@# .@+%@@                                                              @
                                               .@@++++++*@%                .@@                                                              :@@++
                                                   @@+++++++@@                                                                               @@++
                                                      @@+++++++@@                                                                               @
                                                         #@*++++++@@                                                                             
                                                            :@%+%@.                                                                              
                                                               @@                                                                                
                                                               @++#@*                                                                            
                                                               @++++++@@                                                                         
                                                               @@++++++++@@.                                                                     
                                                                  @@*+++++++*@@                                                                  
                                                                     :@@++++++++@@                                                               
                                                                         @@++++++++@@:                                                           
                                                                            @@*+++++++*@@                                                        
                                                                               .@@++++++++@@                                                     
                                                                                   @@++++++++%@-                                                 
                                                                                      @@*+++++++*@@                                              
