           @###@@        @@         .   .          @=                                                                      %@*+##                
           #@@              @@.@=+==@====@#=%@@#@@                                                                      @@++++++@                
           @@@.                #@+=*=+==@%@=#@-                                                                      @@++++++*@@                 
           @+++%@:                :@%+===@@.                                                                     .@@++++++%@-                    
           @@+++++*@*                 @@                                                                      =@#++++++@@.                       
              @@+++++*@@                                     .@@=+++++++**%@@@@@@@@@@@@@@%+-.              @@*++++++@@                           
                 @@++++++@@                               *@*====#+++++++++++++++++++++++++++++++++++++*#%+++++++@@                              
                    @@++++++@@                      @  @@=======@@@@@@@@@@@#*++++++++++++++++++++++++++++++++*@%                                 
                       @@*+++++@@               ..  @+=======@@                      ..=%@@@@@@@@@@@@#*+++%@:                                    
                          +@*+++++@@.            @==+====@@-                                                                                     
                             :@#+++++%@:      @=====#===@                                                                                        
                                .@@+++++*@*@====@===#===@                                                                                        
                                    @@++++@====+==*=%===@                                                                                        
                                       @@+@===*#===#@===@                                                                                        
                                          @====@====@===@                                                                                        
                                          @====@*===%===@                                                                                        
                                          #+===#=+==#===@                                                                                        
                                          -#===+===##===@                                                                                        
                                          .@====@===%===@                                                                                        
                                           @=====@==+=@  .@@                                                                                     
                                           @=======*         @@                                                                                  
                                           @====-               @@                                                                               
                                           @=.               .@@+@                                                                               
                                           @@:                @@*@                                              .@%@                             
                                           @++*@#                -@+                                           .@=@@@                 %@*===     
                                           @++++++@@                .@@                                       @*==@=@=@             :%=%==+=@.   
                                           .@@+++++++@@                 @@                                 :@+=@@   @@==*  +@     @@=#==*=@=%@*  
                                               @@+++++++@@.                @@.                           *+=@@         @@+=%@@.  @==%==@@ @@===@#
                                                  @@*++++++%@:                *@=                       @@@               :@@==%@==@@=       =@%=
                                                     +@#++++++*@#                .@@                  @@                      @@@@               
                                                        .@@+++++++@@                 @@            @@                                            
                                                            @@+++++++@@                 @@      .@:                                              
                                                               @@+++++++@@                 %@:  -%+*@*                                           
                                                                  *@#++++++%@:                :@@@@                                              
                                                                     .@@++++++*@@                                                                
                                                                         @@+++++++@@                                                             
                                                                            @@+++++++@@                                                          
                                                                               *@*+++@@                                                          
                                                                                  .@                                                             
                                                                                   @+@@.                                                         
                                                                                   @++++*@@                                                      
                                                                                   @++++++++@@                                                   
                                                                                     @@++++++++@@:                                               
                                                                                        %@*+++++++*@@                                            
