              .@@++++++@@   .@@++++++@            @.                                                  %                                          
                  @@*+++++@@++++++#*++@.           @@                                                                                            
@@                   -@@+++*+++@@ :@+++@@           .@                                                                                           
   @@.                   @@@@:    .@++++*@            @                                                                                          
      %@.                         .@++++++@            @                                                                                         
         =@+                      .@+++++++@.           @.                                                                                       
          @@@                     .@++++++++@+           %@                                               @#*@                                   
      .@@+++@                     .@+++++++++*@           .@                                            @=%%=#@                                  
   *@#++++++@                     .@+++++++++++@            @                                          :=%=*==@                                  
@@*++++++@@                       .@++++++++++++@            @                                        .#=@@@@=#=+                                
++++++@@                          .@+++++++++++++@.           @.                                     @=@@     @@=%@-                             
++*@*                              @++++++++++++++%@           #@                                   @@           @@==                            
@:                                 @#+++++++++++++++@           .@                               =@.                @@                           
                                     .@@+++++++++++++@            @                           .@=                      @@.                       
                                         @@+++++++++++@.         :  @@#@#@@+=              .@#                            @@.                    
                                            @@+++++++++@#     -       .@#+=*-            @@                                  @@.                 
                                               @@+++++++*@ +             -@=.            @+#@:                                  #@.              
                                                  #@*+#@-                :@@             @++++#@-                                  +@:           
                                        ==+ @  @@:.%@.                %@*++@             @@*+++%@:                                    =@-        
                                        ==@@==*=@@.                @@++++++@                @@.                                          -@=     
                                        ==%==@@                 @@++++++*@@              @@                                                 :@+  
                                        +=@@                :@@++++++%@-              @@                  #@                                   .@
                                       .@+                @@++++++@@               @@                  @@+*++@@.                                 
                                       .@+*@-                @@@@ :.@*@*@. @@ =.@@                  @@++++@+++++*@@                              
                                        @++++#@:               .@@=%==@%==*==@%                 .@@+++++@@.@@+++++++@@.                          
                                        @+++++++%@.               .@@+===*@=                 *@#++++*@@       @@*++++++#@%                       
                                          @@+++++++@@.               .@@.                 @@+++++*@+             :@@+++++++@@                    
                                             @@*++++++@@.                              @@+++++%@:                    @@+++++++@@=                
                                                -@%++++++@@                        .@@+++++@@.                          +@#+++++++@@             
                                                   .@@++++++@@                  +@#+++++@@                                 .@@+++++++@@:         
@                    .@.                               @@+@@                 @@++++++@@                                        @@*++++++*@@      
=@               .@==+*+@                             :@*                 @@++++++@@                                              .@@+++++++@@.  
+=%@             +==+==+=*@                        #@:                .@@++++++@@                                                     @@+++++++*@
 .@@=@-@=@    @=+==#=*#=*=@                     @@                 =@#+++++*@#                                                           =@@+++++
     @@==*+@@@#@==@@    @@=%=*@@             @@                 @@*+++++#@-                                                                  @@++
        @@==%==@@          @@==+==+@.@@@#*@@                 @@++++++@@.                                                                        @
           -@.                =@%=#===%@#                .@@++++++@@                                                                             
                                  @@@-                -@%++++++@@                                                                                
                                                   @@*++++++@@                                                                                   
                                                @@+++++++@@                                                                                      
                                             @@++++++*@@                                                                                         
                                             .@%++*@*                                                                                            
                                                .@+                                                                                              
                                                   :@=                                                                                           
