                              @@++++++#@=   @@+++++++@@:                                                                                         
                                 @@++++++*@+++++++@@                                                                                             
                                    @@++++@++++@@                                                                                                
                                       @@+@*@@                                                                                                   
                                          :                                                                                                      
                                                                                                                                                 
                                                                                                                                                 
                                                                                                                                                 
                                                                                                                                                 
                                                                                                                                                 
                                              ===@                                                                                               
                                            +=%#+*=                                                                                              
@                                          @*==*=#=                                                                                              
 @                                        @=**@@@=%=                                                                                             
  @                                      @=@+     @@==@:                                                                                         
   @:                                   @@           @@#.                                                                                        
    %@                               @@                 @@                                                                                       
     .@                           @@                       @@                                                                                    
    #   @@*=%@=*               @@                             @@                                                                                 
 *        .@*+=%             @.                                  @@.                                                                             
             +@%            .@+%@.                                  %@.                                                                          
             @@@            *#++++#@:                                  %@.                                                                       
         .@@+++@             @@*+++@@                                     *@:                                                                    
      -@#++++++@               .@@                                           =@-                                                                 
   @@*++++++@@              :@*                                                 -@=                                                              
@@+++++++@@              +@-                 .@@                                   :@+                                                           
+++++*@@              @@.                 :@%+@++@@.                                  .@*                                                        
 @@@: @:+*@@@ -@@%@@@.                 %@*++++@+++++*@@                                  .@%                                                     
   .@@=%%=%=+@==@@                  @@+++++@@..@@+++++++@@                                  .@@%@+ @@   -.                                       
      .@#*===@@                  @@+++++@@        @@+++++++#@*                                  @@=%===#*@                                       
         :@@                 :@@+++++@@              -@@+++++++@@                                  @@#%==@                                       
                          %@*+++++@@                     @@+++++++@@-                                 @@=@                                       
                       @@++++++@@                           %@#+++++++@@                               *@@                                       
@@                  @@+++++*@#                                  @@+++++++@@.                        @@++*%                                       
                .@@+++++#@-                                        @@*++++++*@@                  @@+++++%=                                       
             *@*+++++@@.                                              .@@+++++++@@.           @@++++++@@                                         
          @@++++++@@                                                      @@+++++++#@@     @@++++++@@                                            
       @@++++++@@                                                            =@%+++++++@@@++++++@@                                               
   .@@++++++@@                                                                   @@+++++@+++*@@                                                  
*@#++++++@@                                                                         %@*+@*@*                                                     
+++++*@@                                                                               .=                                                        
++#@+                                                                                                                                            
@:                                                                                                                                               
                                                                                                                                                 
