       @                                              @@++++++@++++++@@                                                                          
        @                                                @@+++@+++@@                                                                             
         @.                                                 @@@@@                                                                                
          @#                                                                                                                                     
           .@                                                                                                                                    
@            @                                                                                                                                   
+@            @                                                                                                                                  
++@            @.                                                                                                                                
+++@=           @%                                                 *                                                                             
++++#@           .@                                              @=+=+                                                                           
++++++@            @                                           =+++%=%-                                                                          
+++++++@            @                                          @===**@@+                                                                         
++++++++@.           @:                                       @#=@* @@=*@.                                                                       
+++++++++%@           @@                                     +@@       @@==@                                                                     
+++++++++++@           .@                                  @@             @@@                                                                    
++++++++++++@            @                              @@                   @@                                                                  
@++++++++++++@.           @@   @  @@                 @@                         @@                                                               
  @@++++++++++@*       =     @%#=%==              *@.                              @@                                                            
     @@++++++++*@   :          :@=*+             @@.                                  @@.                                                        
        @@++++++@@                @@             @++%@.                                  @@.                                                     
@@         @@@@                 @@+@            **+++++%@.                                  @@.                                                  
*=@@@@@=+@@@                 @@++++@              @@*+@@                                       #@.                                               
=@=@@==@@                :@%++++++%@               @@                                             +@:                                            
==%+@+                %@*++++++@@              .@@                                                   =@-                                         
%@:                @@+++++++@@              -@+                  @@@@                                   -@=                                      
#@:                @@+++*@@              *@:                 :@@++@+++@@:                                  :@+                                   
*++%@.               .@@#.*@=====@@=@@@@.                 #@*++++#@++++++*@@                                  .@# .                              
*+++++%@.               .@#=%===@==@@                  @@+++++@@.  .@@+++++++@@.                                 .@@%@.@%@: %@                   
@@+++++++@@                :@#==@@                  @@+++++@@          @@*++++++#@@                                 .@@=%==+=@                   
   @@+++++++@@                :                 .@@+++++@@                :@@+++++++@@                                 .@@=%=@                   
      @@*++++++@@                            +@#+++++@@                       @@+++++++%@+                                 @@@                   
         -@%++++++@@                      @@++++++@@                             +@%+++++++@@                             =@#@                   
            .@@++++#@:                 @@++++++@@                                   .@@+++++++@@:                      #@*++*@                   
                @@.                .@@+++++*@+                                          @@*++++++*@@                @@++++++@-                   
             @@                 +@#+++++%@:                                                .@@+++++++@@.         @@++++++@@                      
          @@                 @@++++++@@.                                                       @@*++++++*@@   @@++++++@@                         
      .@@                 @@++++++@@                                                              -@@+++++++@++++++@@                            
.  =@+                .@@++++++@@                                                                     @@++++@+++@@                               
@@.                =@#++++++@@                                                                           *@#@@@                                  
                @@*++++++@@                                                                                                                      
             @@++++++*@%                                                                                                                         
         .@@++++++#@=                                                                                                                            
      -@%++++++%@.                                                                                                                               
    @#++++++@@.                                                                                                                                  
