       :@@+++++*@@      @@++++*@            @                                                  @@@:                                              
           @@++++++@@@@+++++++++@            @                                                                                                   
              %@#++++@++++%@%@+++@            @-                                                                                                 
                 .@@+%*@@    @++++@=           *@                                                                                                
@.                           @+++++#@           .@                                                                                               
  +@-                        @+++++++@            @                                                                                              
     @@                      @++++++++@            @                                                .@@                                          
  @@++@                      @+++++++++@.           @-                                             @%=*=@                                        
@+++++@                      @++++++++++%@           =@                                           #=*===@                                        
++++@@.                      @++++++++++++@           .@                                         #===%=@=%*                                      
+@@                          @+++++++++++++@            @                                       @*#@.  @@+=@:                                    
                             @++++++++++++++@            @                                     @@:        @@==                                   
                             @+++++++++++++++@*           @+                                .@*              @@                                  
                              :@%+++++++++++++*@           -@                             @@                    @@                               
                                 .@@++++++++++++@            @@..@@ @*@                @@                          @@.                           
                                     @@++++++++++@       @      @@+=*=@             @@                                @@.                        
                                        @@++++++++@-  %           .@+=+            @#@:                                  %@.                     
                                           @@*++++@@                 @#            @+++#@:                                  #@.                  
                                  @+-      .  +@%                .@@+%-            @++++++#@                                   =@:               
                                  #=@==@#@=*@=                +@#++++@.              +@%@#                                        -@-            
                                  #===+=@@.                @@+++++++@@              +@-                                              -@=         
                                  @==@@.                @@+++++++@@              %@.                                                    :@*      
                                  @@                .@@++++++*@#              @@                  -@%*@@                                   .@%   
                                  @*@-                @@++@@.  @           @@                  @@*++*++++%@+                                  .@@
                                  @+++#@:                @@@*=*====@=*+@@@                  @@+++++@@@+++++++@@                                  
                                  @++++++%@.               .@@=+==+==@@                 .@@+++++@@     @@+++++++@@:                              
                                   @@+++++++%@.               .@#=@@                 -@%+++++@@           *@#++++++*@@                           
                                      @@+++++++@@                                 @@*+++++@@                 .@@+++++++@@.                       
                                         *@#++++++@@                           @@+++++*@#                        @@*++++++*@@                    
                                            .@@++++++@@                     @@+++++#@=                              .@@+++++++@@                 
                                                @@+++@@                 :@@+++++@@.                                     @@+++++++#@#             
            .@@=@=@                               @@                 @@*+++++@@.                                           =@@+++++++@@          
           @@==#@+@-                          .@@                 @@++++++@@                                                   @@+++++++@@=      
  @=     @@#=#*=+===#                      -@*                 @@++++++@@                                                         @@#+++++++@@  @
=*#+*  .@=#+%*@*.@@=@#@:                @@:                :@@++++++@@                                                                @@++++++@++
 @@==*=#=*@@.       @@====@@@   = @*+@@.                #@*+++++*@@                                                                      @@*++@++
    #@*@@              %@+=@===*%=@@                 @@++++++*@*                                                                            :@@@.
                          .@@==@@                 @@++++++%@:                                                                                    
                                              .@@++++++@@.                                                                                       
                                           #@*++++++@@.                                                                                          
                                        @@+++++++@@                                                                                              
                                      .@%+++++@@                                                                                                 
                                         .@@@                                                                                                    
                                            :@=                                                                                                  
