  -            @.                                              @@+++++#++++%@:                                                                   
@#+@.           @#                                                %@*+#+@@                                                                       
++++@+           :@                                                  *@                                                                          
++*++*@            @                                                                                                                             
@ @++++@            @                                                                                                                            
  @+++++@            @.                                                                                                                          
  @++++++@:           @%                                                                                                                         
  @+++++++#@           .@                                                                                                                        
  @+++++++++@            @                                                *=@-                                                                   
  @++++++++++@            @                                             @===%=                                                                   
  @+++++++++++@.           @.                                          @=#===#                                                                   
  @++++++++++++@@           @@                                        @==@@@=+=@                                                                 
  @+++++++++++++*@           .@                                      @=@@    @@%#@%                                                              
  @+++++++++++++++@            @                                    @@          %@=@                                                             
  @@+++++++++++++++@            @                                @@                %@.                                                           
     @@+++++++++++++@=           @:                           +@.                     *@:                                                        
        @@+++++++++++#@         .. @@@@=@#+@               :@-                           =@-                                                     
           @@++++++++++@     ..       @@===@             @%                                 -@=                                                  
              #@*+++++++@  :             @%@            =#*@@                                  :@+                                               
                 -@%++%@.                =@@            @++++*@%                                  .@*                                            
       @*@    *@@  @@.                @@+++@            %@#++++@@                                    .@@                                         
       @===@====@@                 @@++++++@               .@@                                          .@@                                      
       @==@==@@                .@@++++++#@*              @@                                                .@@                                   
       @==@@                +@#++++++@@.              @@                  @                                    @@                                
       @@                 @+++++++@@              .@@                  @@+@+@@-                                   @@                             
       @++@%                @@+@@ . @@.=@  %@  :@%                 .@@++++#++++*@@                                   @@                          
       @+++++@%                @@=@=*%#%@=+=%@=                 :@%++++*@@@@+++++++@@.                                  @@=@   -                 
       @+++++++*@=                @@==@==%@:                 @@*++++*@+      @@*++++++*@@                                  @@=@====@=@           
         @@+++++++*@-                @@@.                 @@+++++%@:            .@@+++++++@@.                                 @@=#===@           
            +@#++++++#@:                               @@+++++@@.                   @@*++++++#@@                                 @@==+           
               .@@++++++%@.                        :@@+++++@@                          :@@+++++++@@                                 @-           
                   @@++++++@@                   @@*+++++@@                                 @@+++++++@@+                         .@@+@.           
                      @@**@%                 @@++++++@@                                       *@#+++++++@@                   :@%++++@            
                      +@-                 @@++++++@@                                             .@@+++++++@@:            =@#+++++%@:            
                   @@.                .@@+++++*@%                                                    @@*++++++*@@      #@*+++++@@.               
                @@                 #@*+++++#@=                                                          .@@+++++++@@@@++++++@@                   
             @@                 @@++++++@@.                                                                 @@++++++*++++@@                      
+=@..@%@+@@@                 @@++++++@@                                                                        =@@++*+@@                         
=*=@==+@=                .@@++++++@@                                                                               @@                            
 @@@@.                *@*++++++@@                                                                                                                
                   @@+++++++@@                                                                                                                   
                @@++++++*@@                                                                                                                      
            .@@++++++*@*                                                                                                                         
             @@+++#@-                                                                                                                            
