                                         @@+++++++@@@@+++++++@@                                                                                  
                                            @@*++++*+++++*@@                                                                                     
                                               #@*+*++%@-                                                                                        
                                                  =@@                                                                                            
@:                                                                                                                                               
 *@                                                                                                                                              
  .@                                                                                                                                             
    @                                                                                                                                            
     @                                                                                                                                           
      @-                                               :@@-                                                                                      
       *@                                            .@#=%=@                                                                                     
         @                                           +=%==%@                                                                                     
          @                                         @==#@=+==@                                                                                   
           @                                       @=@@   %@#=@@                                                                                 
=           @-                                    @@.        +@+=                                                                                
#@           +@                                -@:              -@-                                                                              
++@            @                            .@*                    :@+                                                                           
+++@            #@:@@@ @=@                @@                          :@+                                                                        
++++@.      *      @@=+==@             @@                                .@*                                                                     
+++++%@  #            @@=@            @+@@                                  .@@                                                                  
@+++*@%                 @@            @++++@@                                  .@@                                                               
 +@-                -@%+#*            @#+++++*@                                   .@@                                                            
.                @@*++++#-               @@@:                                         @@                                                         
              @@+++++++@@              @@.                                               @@                                                      
          .@@++++++*@@              @@                                                      @@                                                   
       .@%++++++@@:              @@                  @@*#%@-                                   @@                                                
         @@++@@.  @      .    @@                  @@+++*+++++@@                                   @@                                             
            @@@%==@=+=@=@=%@@                  @@+++++@@@+++++++@@.                                  @@@@                                        
               @@==%+===@%                 :@@+++++@@     #@#++++++*@@                                  @@*#@==+@@=#                             
@*                @@+@=                 #@*+++++@@           .@@+++++++@@.                                 @@===+==.                             
++*@+                                @@+++++*@*                  @@*++++++#@@                                 @@==+                              
+++++*@-                          @@+++++#@-                        :@@+++++++@@                                 @@                              
@@++++++#@.                   .@@+++++@@.                               @@+++++++%@*                           @@+@                              
   @@*++@@                 #@#+++++@@                                      +@%+++++++@@                     @@++++@                              
    .@@                 @@++++++@@                                             @@+++++++@@-              @@+++++*@@                              
 -@#                 @@++++++@@                                                   @@*++++++*@@       .@@+++++*@%                                 
:                .@@++++++@@                                                         .@@+++++++@@.:@#+++++#@=                                    
              +@#+++++*@@                                                                @@++++++#+++++%@:                                       
           @@++++++#@=                                                                      -@@++#++@@.                                          
        @@++++++%@:                                                                             @@@                                              
    .@@++++++@@.                                                                                                                                 
 +@#++++++@@                                                                                                                                     
*++++++@@                                                                                                                                        
++++@@                                                                                                                                           
