    @@*+++++@@.       @@+++*@            @                                                  @@@@                                                 
       -@@+++++#@* @@++++++++@            @                                                                                                      
           @@+++++@+++++@@@+++@            @:                                                                                                    
              %@#+@+#@@   @++++@-           *@                                                                                                   
                 .@       @+++++#@           .@                                                                                                  
@                         @+++++++@            @                                                                                                 
  @@                      @++++++++@            @                                                 -#                                             
@@+@                      @+++++++++@.           @-                                             .@#==@                                           
+++%:                     @++++++++++@@           +@                                           @%=%@*@                                           
++@@                      @+++++++++++*@           .@                                          @==*===@:                                         
@                         @+++++++++++++@            @                                       @=+@@ .@@@*@                                        
                          @++++++++++++++@            @                                     @@@        @@==-                                     
                          @+++++++++++++++@+           @=                                 *@              @@                                     
                           @@++++++++++++++*@           =@                             :@:                   @@                                  
                              #@*++++++++++++@            @%  :: @@@                .@*                         @@                               
                                 :@%++++++++++@        -    -@=@=%=@              @@                               @@                            
                                    .@@++++++++@:   +          @@=@@            @@@                                   @@                         
                                        @@+++++*@:                @@            @+++@@                                   @@                      
                               *@%         @@@:                =@#+@            @++++++@@                                   @@                   
                               @#*@=#@+%@@@.                @@*++++@              @@+@@.                                       @@                
                               @*=====@@                 @@+++++++@=              @@.                                             @@             
                               @@==@@                .@@++++++*@#              @@                                                    @@          
                               @@@                =@%++++++@@.              @@                  @@@@@                                   @@.      
                               @@@                :@#+++@@  .            @@                  @@+++*+++@@                                   #@.   
                               @+++@@                -@@#@=%==#=@@=%@=@@                  @@+++++@+++++++#@*                                  #@.
                               @++++++@@                *@%=@=*====@#                 :@%+++++@@   -@@+++++++@@                                  
                               =@%+++++++@@                %@=+*@-                 @@*++++*@%          @@+++++++@@-                              
                                  .@@+++++++@@                .                 @@+++++#@=                %@#++++++*@@                           
                                      @@+++++++@@                            @@+++++%@:                       @@+++++++@@.                       
                                         @@*++++++@@                     :@@+++++@@.                             @@*++++++*@@                    
                                            -@%++++@@                 %@*+++++@@                                    .@@+++++++@@.                
           @@==@                               .@@                 @@++++++@@                                           @@+++++++#@@             
        #=@==%=*                            =@=                 @@++++++@@                                                 =@%+++++++@@         :
      =@=%@=@@==%=                       @@.                .@@++++++@@                                                        @@+++++++%@+  =@#+
=@   @==+#=@@@@===@:                  @@                 *@*+++++*@*                                                              #@*++++++**++++
@=#==+@=@@      :@@=@==@+.      .  @@                 @@++++++#@-                                                                    .@@+++*+++@@
 @@=*@#             @@=====@==*=@@                 @@++++++@@.                                                                           @@*@@   
                       @@+==+@*                .@@++++++@@                                                                                       
                          .:                *@#++++++@@                                                                                          
                                         @@+++++++@@                                                                                             
                                      @@+++++++@@                                                                                                
                                   .@++++++*@@                                                                                                   
                                      @@*@+                                                                                                      
                                         @@                                                                                                      
