                            @@*++++++@@    @@+++++++%@-                                                                                          
                               +@*++++++@@+++++++@@                                                                                              
                                  -@#++++*++++@@                                                                                                 
                                     .@%+*+@@                                                                                                    
                                        .=                                                                                                       
                                                                                                                                                 
                                                                                                                                                 
                                                                                                                                                 
                                                                                                                                                 
                                                                                                                                                 
                                            :==#@                                                                                                
                                          .==%%%#                                                                                                
                                          @+====%                                                                                                
@                                        @=+*@@*=*@                                                                                              
 @                                      %=@*    :@#==@                                                                                           
  @                                   .@@          .@%@                                                                                          
   @.                               @@                .@%                                                                                        
    @%                           @@                      .@@                                                                                     
   %  =@*@=@@@@               @@                             @@                                                                                  
+        @@=#=@            .@.                                  @@                                                                               
            @@@            @*+@@                                   @@                                                                            
            @@@            @+++++@@                                   @@                                                                         
         @@+++@            .@@++++@@                                     @@                                                                      
     :@%++++++@               .@@                                           @@                                                                   
  @@*++++++@@              :@#                                                 @@                                                                
@+++++++@@              +@-                 .@.                                   @@                                                             
++++*@@              @@.                 :@@+@+*@@                                   @@                                                          
@%@- +==@+@@ .@#++@@.                 #@*++++*+++++@@.                                  @@                                                       
  @@=*==+%*@#==@@                  @@+++++@@.@@*++++++#@%                                  @@=@...@.   .                                         
     @@==@==@@                  @@+++++@@       :@@+++++++@@                                  %@=@====##@                                        
        @@@                 .@@+++++@@              @@+++++++%@+                                 %@==+==@                                        
                         #@#+++++@@                    +@@+++++++@@                                 *@==-                                        
                      @@++++++@@                           @@+++++++@@:                               +@.                                        
.                  @@+++++*@@                                 @@#++++++*@@                         %@*+@                                         
               .@@+++++#@=                                       .@@+++++++@@.                  @@+++++@                                         
            +@#+++++%@.                                              @@*++++++*@@            @@++++++@@                                          
         @@++++++@@.                                                    :@@+++++++@@.     @@++++++@@                                             
      @@++++++@@                                                            @@+++++++#@@@++++++@@                                                
  .@@++++++@@                                                                  +@#+++++*++++@@                                                   
@#++++++@@                                                                        .@@++**@%                                                      
++++*@@                                                                               @+                                                         
+*@*                                                                                                                                             
-                                                                                                                                                
                                                                                                                                                 
