          -@#@            @                                                @@+++*++@@                                                            
@      -@*++++@            @                                                  @@@@                                                               
++@@:@#++++++++@            @.                                                                                                                   
++++@+++++@@@+++@.           @%                                                                                                                  
.@@+@+@@-   @++++@@           .@                                                                                                                 
    %       @+++++*@            @                                                                                                                
            @+++++++@            @                                                                                                               
            @++++++++@            @.                                                @@                                                           
            @+++++++++@+           @@                                             #@#+=@                                                         
            @++++++++++*@           .@                                           @==%+#%                                                         
            @++++++++++++@            @                                          @==@=%=@@                                                       
            @+++++++++++++@            @                                       @*=@@  @@@=@.                                                     
            @++++++++++++++@:           @:                                    @@@        @@===                                                   
            @+++++++++++++++#@           %@                                 @@              @@                                                   
             -@%++++++++++++++@           .@                             @@                    @@                                                
                .@@++++++++++++@           .@@  :@ @@@                =@.                         @@                                             
                    @@++++++++++@.      ..     @@*=#=@             .@=                               @@.                                         
                       @@++++++++@@  ..          :@++@            @%@:                                  %@.                                      
                          @@+++++@@:                @@            @+++#@:                                  %@.                                   
                 @@@         *@@.                @@*+@            @++++++#@                                   *@:                                
                 @==%=@@=+#@@                 @@+++++@              *@#@@                                        =@:                             
                 @@==%==@@                 @@++++++#@:              @@                                              -@=                          
                 @*==@@                =@#++++++@@.              @@                                                    :@+                       
                 @@+                @@*++++++@@              .@@                  @@@@@                                   .@*                    
                 @*@-                @@+++@@  +           :@#                 .@@+++*+++@@=                                  .@%                 
                 @+++#@:                @@@@=#==%=*@=#@*@-                 :@%++++*@@+++++++@@                                  .@@+#            
                 @++++++%@.               .@@=*=#%==%@.                 %@*++++#@=    @@+++++++@@:                                  @@=@===@%@=@ 
                 .@@+++++++@@.               .@#*@@.                 @@+++++%@:          %@#++++++*@@                                 .@@=@====@ 
                     @@+++++++@@                                  @@+++++@@.                .@@+++++++@@.                                 @@=#=: 
                        %@*++++++@@                           :@@+++++@@                        @@*++++++*@%                                 @@  
                           .@@++++++@@                     @@*+++++@@                              :@@+++++++@@                            .@@@  
                               @@+++*@%                 @@++++++@@                                     @@+++++++%@+                     :@%+++@  
=@                               +@-                 @@++++++@@                                           *@%+++++++@@               +@*+++++%@  
=+.                           @@.                .@@+++++*@*                                                  @@+++++++@@:        @@*+++++@@     
==*=.                      @@                 *@*+++++#@-                                                        @@*++++++*@@  @@++++++@@        
@@=%*@.                 @@                 @@++++++@@.                                                              .@@+++++++++++++@@           
   @@=+==@@@     .@..@@                 @@++++++@@                                                                      @@*++++++@@              
      @@+=%==@===*@=                .@@++++++@@                                                                            -@%@@                 
         .@@==@@.                #@#++++++@@                                                                                                     
                              @@+++++++@@                                                                                                        
                           @@++++++*@@                                                                                                           
                       .@@++++++*@+                                                                                                              
                      @%+++++%@:                                                                                                                 
                        .@@@.                                                                                                                    
