             @@++++++@@    :@#+++++@*           :@                                                  +@                                           
                %@#+++++@@#++++++*++*@            @                                                                                              
.                  .@@+++@+++*@@ @++++@            @                                                                                             
 +@-                   @@@@@.    @+++++@            @.                                                                                           
    :@#                          @++++++@-           @@                                                                                          
       .@@                       @+++++++#@           .@                                                                                         
        .@@.                     @+++++++++@            @                                                *=@+                                    
     =@#++*@                     @++++++++++@            @                                             @===%=                                    
  @@*++++++@                     @+++++++++++@.           @:                                          @=*===%                                    
@+++++++@@                       @++++++++++++@@           %@                                        @==@@@=+=@                                  
++++*@*                          @+++++++++++++*@           .@                                      @=@@    %@%*#@                               
+%@:                             @+++++++++++++++@            @                                    @@          %@=@                              
                                 @@+++++++++++++++@.           @                                @@                *@:                            
                                    @@+++++++++++++@+           @:                           *@.                     =@:                         
                                       @@+++++++++++*@         .. @@@@=@%*@               -@:                           -@=                      
                                          @@++++++++++@     ..       @@===@             @*                                 :@+                   
                                             *@*+++++++@  :             @%@            =#+@@                                  .@*                
                                                :@%++@@.                *@@            @+++++@@                                  .@#             
                                      @*@ .  #@@  @@                 @@+++@            *@#++++@@                                    .@@          
                                      @===@====@@                 @@++++++@                @@                                           @@       
                                      @==@==@@                .@@++++++#@=              @@                                                .@@    
                                      @==@@                *@#++++++@@.              @@                  @                                    @@ 
                                      @@                 @+++++++@@              .@@                  @@+@+@@=                                   
                                      @++@@                @@+@@ ..%@.*@  @@..:@#                 .@@++++#+++++@@                                
                                      @+++++@@                @@=@=+%#@@=+=%@-                 -@#++++*@#@@+++++++@@:                            
                                      @+++++++*@*                @@==@==%@.                 @@*++++#@=      @@#++++++*@@                         
                                        @@*++++++*@=                @@@                  @@+++++@@.            .@@+++++++@@.                     
                                           =@#++++++#@:                              .@@+++++@@.                   @@*++++++*@@                  
                                              .@@++++++%@.                        -@%+++++@@                          :@@+++++++@@               
                                                  @@++++++%@                   @@*+++++@@                                 @@+++++++%@*           
                    -:                               @@**@#                 @@++++++@@                                       +@%+++++++@@        
.               @@=%**=                              #@:                 @@++++++@@                                             .@@+++++++@@-    
@@             @%=%+===%@                         @@.                :@%+++++*@*                                                    @@*+++++++@@ 
@@=@.-@*=    @====+##=#==+                     @@                 %@*+++++#@-                                                          .@@+++++++
   @@==%+@#@+=%==@@   @@=+=@@@             .@@                 @@++++++@@.                                                                 @@++++
      +@*====*@*         #@+=%=+=@..@@@+@@%                 @@++++++@@                                                                        -@@
         .@@.               .@@=+=%+=*@-                :@@++++++@@                                                                              
                                @@@@.                %@*++++++@@                                                                                 
                                                  @@+++++++@@                                                                                    
                                               @@++++++*@@                                                                                       
                                           .@@++++++#@=                                                                                          
                                            @@+++%@:                                                                                             
                                               @@                                                                                                
                                                  @@                                                                                             
