@@#+++++#@+        @@+++@.           *@                                                 @@**@@                                                   
   .@@++++++@@  @@+++++++%@           .@                                                                                                         
       @@*+++++@++++++@@+++@            @                                                                                                        
          -@%++@++@@:  @++++@            @                                                                                                       
              @@%      @+++++@.           @-                                                                                                     
                       @++++++@*           +@                                                                                                    
-                      @+++++++*@           .@                                                                                                   
@                      @+++++++++@            @                                               @=#=@                                              
@                      @++++++++++@            @                                            @=#==%@                                              
@.                     @+++++++++++@:           @=                                          #*==*=%.                                             
                       @++++++++++++#@           =@                                       -=#=@-@@=#@                                            
                       @++++++++++++++@            @                                     @=@%      @@+=@                                         
                       @+++++++++++++++@            @                                   @@            @@@                                        
                       +@*++++++++++++++@.           @                               @@                  @@                                      
                          :@%++++++++++++@@           @@   .  #-                  @@                        @@                                   
                              @@++++++++++*@        #    @@#=%+=@              @@                              @@                                
                                 @@+++++++++@    =         :@+*=@            @@.                                  @@.                            
                                    @@+++++++@.               @@@            @++@@.                                  @@.                         
                             -         %@*@@                 @@*#            @+++++%@.                                  %@.                      
                            @+@+@ .+=@@@@                .@@+++#=             @@*++@@                                      *@:                   
                            @=%==@*=@%                -@%++++++@.              .@@                                            *@:                
                            @===*@=                @@*++++++@@              :@*                                                  =@-             
                            @%@.                @@+++++++@@              =@-                  @@@                                   -@=          
                            @@:                @@++++*@@              %@.                 :@@+++++@@.                                  :@*       
                            @++#@.                @@= @@@=+@+@#@=:@@@                  @@*++++%++++++*@@                                  .@#    
                            @+++++@@.               .@%%@====%#=@@                  @@+++++@@. .@@+++++++@@.                                 .@%@
                            @@+++++++@@.               .@*===@@                  @@+++++@@         @@*++++++#@%                                 .
                               @@+++++++@@                -@                 :@@+++++@@               -@@+++++++@@                               
                                  @@*++++++@@                             #@*+++++@@                      @@+++++++@@=                           
                                     =@#++++++@@                       @@++++++@@                            *@#+++++++@@                        
                                        .@@+++++%@                  @@+++++*@%                                   @@+++++++@@:                    
         @#@*                               @@@.                .@@+++++#@=                                         @@*++++++*@@                 
     %==#=@+@                             @@                 *@#+++++@@.                                               .@@+++++++@@.          @@+
    .#=%=*%=*=@                        @@                 @@++++++@@.                                                      @@+++++++*@%    @@++++
  @%#=%==@@#=+=@                   .@@                 @@++++++@@                                                             =@@+++++++@@++++++@
@=#+=*@+     @@=#==@.           =@=                .@@++++++@@                                                                    @@++++#++++@@  
==@@.           @@==*===@%=#=@@.                +@#++++++@@                                                                          @@##*@@     
:                  +@#=#@=@@                 @@++++++*@@                                                                                .        
                       @@                 @@++++++*@+                                                                                            
                                      .@@++++++%@:                                                                                               
                                   =@#++++++@@.                                                                                                  
                                -@*++++++@@                                                                                                      
                                  :@#+@@                                                                                                         
                                     -@:                                                                                                         
