@@           :@#*@            @                                                :@%+#++@@                                                         
+++@@.    :@#+++++@            @                                                  .@@                                                            
@+++++#@@%+++++++++@            @-                                                                                                               
  @@++++@++++@@ @+++@=           +@                                                                                                              
     @@#@@@:    @++++#@           .@                                                                                                             
                @++++++@            @                                                                                                            
                @+++++++@            @                                                                                                           
                @++++++++@.           @=                                               %#@%                                                      
                @+++++++++@@           =@                                            -@@=+=@                                                     
                @+++++++++++@            @                                          .==#==@@                                                     
                @++++++++++++@            @                                         @==@@*=+=@                                                   
                @+++++++++++++@            @.                                      %=@@   :@%+%@                                                 
                @++++++++++++++@*           @+                                    @@         .@#=.                                               
                @+++++++++++++++*@           -@                                @@               .@%                                              
                  @@++++++++++++++@            @                            *@.                    .@@                                           
                     @@*+++++++++++@          . -@@@@@:@=@               -@:                           @@                                        
                        =@#+++++++++@-     ..      @@=#=*@            .@#                                .@@                                     
                           .@@+++++++#@  :            @@=#            @+@@                                   @@                                  
                               @@+++%@.                =@*            @++++@@                                   @@                               
                     #=%    .@@  @@.                @@*+%=            @@+++++@@                                    @@                            
                     #=*=%+===@@                 @@+++++@.               @@@                                          @@                         
                     %==%==@@                .@@++++++#@*              @@                                                @@                      
                     @==@@                +@#++++++@@.              @@                  .                                   @@                   
                     @*                #@*++++++@@              .@@                  @@+**@@                                   @@                
                     @+@@                %@*+@@  :@. ..  +   .@@                 .@@+++*+++++@@.                                  @@.            
                     @++++@@                %@*%==%==+*=*+*@=                 :@%++++*@@@*++++++%@*                                  @@@@.       
                     @+++++++@@                @@==@@==%@.                 @@*++++*@+     -@@+++++++@@                                  @@@+@===@
                      +@#+++++++@@                @@@@.                 @@+++++%@:            @@+++++++@@-                                 %@===%
                         .@@+++++++@@                                @@+++++@@.                  *@#+++++++@@                                 *@=
                             @@++++++*@#                         :@@+++++@@                         .@@+++++++@@.                                
                                @@*+++++*@+                   @@*+++++@@                                @@*++++++*@@                          .@@
   .                               =@#+*@@                 @@++++++@@                                      .@@+++++++@@                    :@%+++
@==@=@                              +@-                 @@++++++@@                                             @@+++++++#@#             =@#+++++%
==+%*=@@                         @@.                .@@+++++*@#                                                   =@@+++++++@@       @@*+++++@@. 
@#=+@==@                      @@                 *@*+++++#@-                                                          @@+++++++%@=@@++++++@@     
@@  @@=*=@@#-             .@@                 @@++++++%@.                                                                @@#+++++%+++++@@        
       :@@=@==#@: .@.@@@@@                 @@++++++@@                                                                       .@@++%++@@           
           @@=====*#*@=                .@@++++++@@                                                                              @@@              
              @@=@@.                #@*++++++@@                                                                                                  
                                 @@+++++++@@                                                                                                     
                              @@++++++*@@                                                                                                        
                          .@@++++++*@*                                                                                                           
                          @@++++%@:                                                                                                              
                             @@.                                                                                                                 
