                                     .@@++++++@@.@@*++++++*@#                                                                                    
                                         @@+++++*++++++@@.                                                                                       
                                            @@++*+++@@                                                                                           
                                               @@@@                                                                                              
                                                                                                                                                 
                                                                                                                                                 
@                                                                                                                                                
.@                                                                                                                                               
  @                                                                                                                                              
   @                                                 @@                                                                                          
    @-                                             #%%==@                                                                                        
     *@                                           @==##=@                                                                                        
      .@                                         .*==@=*=@=                                                                                      
        @                                       @*=@@  @@*=@.                                                                                    
         @                                     @@@        @@==.                                                                                  
          @=                                 @@              @@                                                                                  
           =@                             @@                    @@                                                                               
@            @@  %= @@@                *@.                         @@                                                                            
+@       :     .@+@=@=@             -@:                               @@                                                                         
++@:  ..          #@=%@            @@@                                   @@                                                                      
++@@.                @@            @+++@@.                                  @@                                                                   
@                 @@+*%            @++++++@@                                   @@                                                                
               @@++++#+              @@*@@                                        @@.                                                            
           .@@++++++#@.              @@                                              @@.                                                         
        *@#++++++@@.              @@                                                    @@.                                                      
     @@+++++++@@              .@%                  @@@@@                                   *@:                                                   
     .@%+++@@  :           -@=                 .@@+++++++@@.                                  =@-                                                
        .@@@@=%==+=@@=#@#@:                 =@%++++*@*++++++*@@                                  -@=*:                                           
           -@%=%==@==@@.                 @@*++++#@-   .@@+++++++@@.                                 :@*=@%==@=@=@                                
              +@==@@                  @@+++++%@.          @@*++++++#@*                                 .@#=#====:                                
@                                 .@@+++++@@.                -@@+++++++@@                                 .@@=@=.                                
++@@                           -@%+++++@@                        @@+++++++%@-                                .@@                                 
+++++@@                     @@*+++++@@                              #@#+++++++@@                            .@@@                                 
@@+++*@#                 @@++++++@@                                     @@+++++++@@.                     -@#+++@                                 
  *@:                 @@+++++*@@                                           @@*++++++*@@               *@*+++++@@                                 
@.                :@@+++++*@+                                                 .@@+++++++@@.        @@*+++++@@.                                   
               @@*+++++%@:                                                        @@+++++++#@@  @@++++++@@                                       
            @@++++++@@.                                                              =@%++++++*++++++@@                                          
        .@@++++++@@.                                                                     @@+++*+++@@                                             
     :@%++++++@@                                                                            %@#@@                                                
  #@*++++++@@                                                                                                                                    
@+++++++@@                                                                                                                                       
++++*@*                                                                                                                                          
+#@-                                                                                                                                             
