++++@@:         =@*+#@            @                                                 @@+@+@@                                                      
@@+++++*@@   -@*++++++@            @                                                   %                                                         
   @@++++++@#++++++@+++@            @.                                                                                                           
      #@#++*+++*@@ @++++@.           @%                                                                                                          
         .@@@@     @+++++%@           .@                                                                                                         
                   @+++++++@            @                                                                                                        
                   @*+++++++@            @                                                                                                       
                   %*++++++++@.           @:                                               ##=@                                                  
                   #*+++++++++@*           %@                                            @=*@=%@                                                 
                   **++++++++++*@           .@                                          @=+=%=+%                                                 
                   +*++++++++++++@            @                                        *==+@@@=@=                                                
                   =#+++++++++++++@            @                                      @=@@     @@==@.                                            
                   =#++++++++++++++@-           @:                                   @@           @@#.                                           
                   .@*++++++++++++++#@           *@                               @@                 @@                                          
                      =@#+++++++++++++@           .@                           @@.                      @@                                       
                         .@@+++++++++++@         :   @@@+@@+=               -@:                            @@                                    
                             @@+++++++++@.    ..       :@+#=@             @+                                  @@                                 
                                @@+++++++@@..             %@+             @+@@.                                  @@                              
                                   @@++@@.                %@@            .@++++@@.                                  @@                           
                        =+=..* +@%. @@                 @@+++@             @@++++@@                                     @@.                       
                        :==+*=+==@@                 @@++++++@                @@                                           #@.                    
                        .==%==@@                :@@++++++%@:              @@                                                 *@:                 
                        .==@#                @@*++++++@@              .@@                  @@                                   +@:              
                        @@.                @@++++++@@              .@#                  @@+@++@@                                   -@-           
                        #*+%@.               .@%@@ #.@@@@@ .@@.*=@=                 .@@++++@+++++%@*                                  :@+        
                        +#++++@@.               .@#=*%=@%====%@.                 *@#++++*@*-@@+++++++@@                                  .@%@*. @
                        -@+++++++@@                :@+@===@@.                 @@+++++#@-       @@+++++++@@-                                 .@%=*
                           @@+++++++@@                =@@                  @@+++++@@.             #@#++++++*@@                                 .@
                              @@+++++++@@                              .@@+++++@@                     @@+++++++@@.                               
                                 %@*++++++@@                        +@#+++++@@                           @@*++++++*@@                            
                                    .@@++++++@@                  @@++++++@@                                 .@@+++++++@@.                        
      =@.                               @@#@+                 @@++++++@@                                        @@+++++++#@@                  -@#
  #+=*=+=+                             %@.                .@@+++++*@@                                              -@%+++++++@@            *@*+++
 .==*===%=*=                        @@                 =@%+++++#@+                                                     @@+++++++%@=     @@++++++@
*=====@+=#=@                     @@                 @@*+++++%@:                                                           %@#+++++++@@@++++++@@  
*==@@   .@@=@=%@-            .@@                 @@++++++@@.                                                                 .@@+++++@++++@@     
@+          @@=@===#@-@@@=*@#                .@@++++++@@                                                                         @@*+@+@@        
               @@+=@=+=#@:                -@#++++++@@                                                                               :@           
                  .@@@.                @@*++++++@@                                                                                               
                                    @@++++++*@@                                                                                                  
                                 @@++++++*@*                                                                                                     
                             -@%++++++%@-                                                                                                        
                              =@*++@@.                                                                                                           
                                 +@.                                                                                                             
