                                  -@#++++++@@. @@+++++++#@+                                                                                      
                                     .@%++++++@++++++@@.                                                                                         
                                        .@@+++@+++@@                                                                                             
                                            @@@@@                                                                                                
                                                                                                                                                 
                                                                                                                                                 
                                                                                                                                                 
                                                                                                                                                 
                                                                                                                                                 
@:                                                 -                                                                                             
 %@                                              @===@                                                                                           
  .@                                           %=*=@=@.                                                                                          
    @                                          @===+=%@.                                                                                         
     @                                        @*=@%.@@=@@                                                                                        
      @-                                     =@@       @@==@                                                                                     
       *@                                  @@            .@@%                                                                                    
        .@                              @@                   @@                                                                                  
          @%   :  @#                 @@                         @@                                                                               
       -    :@=@=%=#              *@.                              @@                                                                            
@   :          %@=@@            .@@                                   @@                                                                         
@@                @@            -%++@@                                   @@                                                                      
                @@+@            @*+++++@@                                   @@                                                                   
             @@++++@              @@++@@                                       @@                                                                
         :@@++++++%@               @@                                             @@                                                             
      %@*++++++@@.             .@@                                                   @@.                                                         
   @@+++++++@@              :@*                  @@@%                                   @@.                                                      
  :@#++++@@              +@-                 .@@++@+++@@                                   @@.                                                   
     -@%::#@==#==@@=@@@@.                 *@#++++*#++++++%@+                                  #@. .                                              
        +@==#=+=%==@@                  @@+++++%@:  -@@+++++++@@                                  +@+@@ *@@ .@@                                   
           @@=*=@@                  @@+++++@@.         @@+++++++@@:                                 =@+=+====@                                   
              #                 .@@+++++@@                #@#+++++++@@                                 -@*=%=@                                   
@                            =@#+++++@@                      .@@+++++++@@.                                :@##                                   
++@@                      @@*+++++@@                             @@*++++++*@%                             -@%*                                   
+++#@:                 @@++++++@@                                   :@@+++++++@@                       +@*++%-                                   
@@.                .@@+++++*@#                                          @@+++++++#@*                %@*+++++@.                                   
                =@%+++++#@-                                                +@%+++++++@@          @@++++++@@                                      
             @@*+++++@@.                                                       @@+++++++%@-   @@++++++@@                                         
          @@++++++@@.                                                             @@*+++++++@++++++@@                                            
      .@@++++++@@                                                                    .@@++++#+++@@                                               
   -@%++++++@@                                                                           @@*#@@                                                  
%@*++++++@@                                                                                                                                      
+++++*@%                                                                                                                                         
++*@=                                                                                                                                            
@:                                                                                                                                               
