      @            @@                                               @@++++#+++#@+                                                                
   @@++@@           .@                                                 @@+#@@.                                                                   
@@++++++*@            @                                                                                                                          
+++++#@+++@            @                                                                                                                         
+*@@  @++++@            @:                                                                                                                       
.     @+++++@+           *@                                                                                                                      
      @++++++*@           .@                                                                                                                     
      @++++++++@            @                                                                                                                    
      @+++++++++@            @                                               *===@                                                               
      @++++++++++@.           @-                                           +=*=+@+                                                               
      @+++++++++++%@           +@                                          @#==*=*.                                                              
      @+++++++++++++@           .@                                        @=%@@@@=#@                                                             
      @++++++++++++++@            @                                     .=@@      @@==@.                                                         
      @+++++++++++++++@.           @                                   *@.           @@@                                                         
      =@#++++++++++++++@#           @+                              -@:                 @@                                                       
         .@@++++++++++++*@           =@       .                  .@*                       @@                                                    
             @@+++++++++++@         -   @@*=#@=@               @@                             @@                                                 
                @@+++++++++@     +        .@*+=@            .@.                                  @@.                                             
                   @@+++++++@-#              *@@            %*+%@:                                  @@.                                          
             .        @@*#@=                :@@@            @+++++#@:                                  %@.                                       
           @*@.@  @=@@@@.                @@*+++@             @@*++%@:                                     *@:                                    
           @==#====@@.                @@+++++++@               @@.                                           =@-                                 
           @=%==@@                 @@++++++*@@              @@                                                  -@=                              
           @=@@                :@%++++++%@-              @@                  #@@                                   :@+                           
           @@-                @@+++++@@.              @@                  @@++@++@@.                                  .@*                        
           @++#@:               .@@@  @@=+@@@.@@#@@@@                  @@+++++*+++++*@@                                  .@%                     
           @+++++%@.               .@@=@==@=@+==@%                 .@@+++++@@ .@@+++++++@@                                  .@@#@@.@@. .@:       
           @@+++++++@@.               .@#=@=+@+                 +@#+++++@@        @@*++++++#@*                                 .@@=%====+@       
              @@+++++++@@.               :@:                 @@+++++*@#              :@@+++++++@@                                 .@@=%==@       
                 @@*++++++@@                              @@+++++#@-                     @@+++++++%@-                                 @@=:       
                    -@%++++++@@                       .@@+++++@@.                           #@#+++++++@@                               @@.       
                       .@@++++++@:                 +@#+++++@@.                                 .@@+++++++@@.                        @@++@        
                           @@@@                 @@*+++++@@                                         @@*++++++*@@                  @@+++++@        
                         :@@                 @@++++++@@                                               .@@+++++++@@.          .@@+++++*@#         
                      #@-                .@@++++++@@                                                      @@+++++++*@@    :@#+++++#@=            
                   @@.                =@#+++++*@@                                                            =@%+++++++@@*+++++%@:               
%=+.            @@                 @@*+++++#@+                                                                   @@+++++*+++@@.                  
@==+%=+@@=@#=@@                 @@++++++%@:                                                                         #@#+*@@                      
  =@#=%#==@@                .@@++++++@@.                                                                               .                         
     .@@=                -@%++++++@@                                                                                                             
                      @@*++++++@@                                                                                                                
                   @@+++++++@@                                                                                                                   
                @@++++++*@@                                                                                                                      
                 :@#+*@*                                                                                                                         
