          -@@+++++*@%     @@+++++@:           #@                                                  @@.                                            
              @@++++++@@@+++++++++@@           .@                                                                                                
                 #@*+++@++++@@-@++++@            @                                                                                               
@                   .@@@#@@    @+++++@            @                                                                                              
  @@.                          @++++++@.           @-                                                                                            
     #@.                       @+++++++@#           +@                                                                                           
       @@:                     @++++++++*@           .@                                                @+@                                       
    @@++*@                     @++++++++++@            @                                             @===@+                                      
.@@++++++@                     @+++++++++++@            @                                           @=#==+=                                      
++++++@@.                      @++++++++++++@-           @=                                        .+=#@@=@=@                                    
+++@@                          @+++++++++++++#@           =@                                      @+@@.   @@=*@.                                 
@@                             @+++++++++++++++@           .@                                    =@:         @@=@                                
                               @*+++++++++++++++@            @                                .@+               @@                               
                                 =@#+++++++++++++@.           @                             @@                     @@                            
                                    .@@+++++++++++@@          - @@@@%#-=%                @@                           @@                         
                                        @@+++++++++*@      %      .@*#=%@             @@                                 @@.                     
                                           @@++++++++@  @            +@=@            :%%@.                                  @@.                  
                                              @@++++@@                 @@            @++++@@.                                  @@.               
                                    @*@    .%@  :@#                :@@++@            @@+++++*@.                                   %@.            
                                    @===+*=@=#@-                %@*+++++@               +@@=                                         *@.         
                                    @=====@@.                @@+++++++@@              #@:                                               +@:      
                                    @==@@.                @@++++++*@@              @@.                 .                                   =@-   
                                    @@                 @@++++++#@=              @@                  +@#@+@@                                   :@=
                                    @+#@.               .@@+@@.  @%  #  .+   @@                  @@++++%++++@@+                                  
                                    @++++%@.               .@%#==#+*=@=@=@@@                  @@+++++@@@@+++++++@@                               
                                    @+++++++@@                .@*=+%===@@                 .@@+++++@@      @@+++++++@@:                           
                                     .@@+++++++@@                :@%@%                 +@#+++++@@            %@#++++++*@@                        
                                         @@+++++++@@                                @@+++++*@%                   @@+++++++@@.                    
                                            %@*++++++@@                          @@+++++#@+                         @@*++++++*@@                 
                                               :@@++++++@@                   .@@+++++%@:                               :@@+++++++@@.             
                                                   @@++@@                 =@#+++++@@.                                      @@+++++++#@*          
              .@#%%==                               @@                 @@*+++++@@                                             +@%+++++++@@       
             *#=@@=%=@@                         .@%                 @@++++++@@                                                   .@@+++++++@@-   
=*  @@.    @=@==%*=+=*=*                     +@-                 @@++++++@@                                                          @@*+++++++@@
.@@=+=@@.:@=+==%@= .@@=%#@@*              @@.                =@%++++++@@                                                                .@@++++++
    @@==++==@@         @@=+==+%@  @=@@@@@                 @@*+++++*@*                                                                       @@*++
       @@@@               @@+=@=@=#=@@                 @@++++++#@-                                                                             -@
                             .@@*@@                .@@++++++@@.                                                                                  
                                                :@%++++++@@                                                                                      
                                             %@*++++++@@                                                                                         
                                          @@+++++++@@                                                                                            
                                         -@#++++@@                                                                                               
                                            -@%                                                                                                  
                                               +@.                                                                                               
