.          @                                              =@#+++++@+++++@@.                                                                      
            @.                                               :@%++@++@@                                                                          
@            @+                                                 .@@@                                                                             
+@+           -@                                                                                                                                 
++*@            @                                                                                                                                
++++@            @                                                                                                                               
+++++@            @.                                                                                                                             
++++++@:           @*                                                                                                                            
+++++++%@           :@                                                @@*                                                                        
+++++++++@            @                                             %%=%=*                                                                       
++++++++++@            @                                           @==*=@=                                                                       
+++++++++++@.           @.                                         @=+#*=+=@                                                                     
++++++++++++@%           @%                                      @%=@@  :@#=*@                                                                   
+++++++++++++*@           :@                                    :@@        .@%=@                                                                 
+++++++++++++++@            @                                 @@              .@#                                                                
@@++++++++++++++@            @                             @@                    .@%                                                             
   @@*+++++++++++@-          .:@:-.@..=%                #@.                          @@                                                          
      =@#+++++++++#@      :      @@=#=*@             -@:                                @@                                                       
         .@@++++++++@  ..           @@=@            .@@@                                   @@                                                    
             @@++++@@.                #@            @*+++@@                                   @@                                                 
   @%@      :   @@                 @@++@            @%++++++@=                                   @@                                              
   @====@%===@@                 @@+++++@               @@@@                                         @@                                           
   @*==@==@@                :@@++++++%@:              @@                                               @@                                        
   @==%@@                #@*++++++@@.             .@@                                                     @@                                     
   @@-                @@+++++++@@              :@#                  @@@#@@                                   @@                                  
   @+@@                *@*++@@  @.      .   =@-                 .@@+++@++++@@                                   @@                               
   @++++@@                @@@@==@=+==@=+@%@.                 *@#++++*@@+++++++@@+                                  @@@@.                         
   @+++++++@@                @@==@*@==@@                  @@+++++%@:    =@@+++++++@@                                  @@==@=+=@*=@               
    +@#+++++++@@                @@%@@                  @@+++++@@.           @@+++++++@@:                                 @@======@               
       .@@+++++++@@                                .@@+++++@@                  %@*++++++*@@                                 #@==*@               
           @@+++++++@#                          =@#+++++@@                        .@@+++++++@@.                                +@-               
              @@++++++*@+                    @@*+++++@@                               @@*++++++*@%                           :@%%-               
                 *@#++#@+                 @@++++++@@                                     :@@+++++++@@                     +@#+++@.               
                   @@.                .@@+++++*@%                                            @@+++++++#@+              #@*+++++@@                
                @@.                =@%+++++#@-                                                  *@%+++++++@@        @@++++++@@                   
             @@                 @@*+++++@@.                                                         @@+++++++@@- @@++++++@@                      
         .@@                 @@++++++@@.                                                               @@*++++++#+++++@@                         
 ...@*#@%                .@@++++++@@                                                                      .@@+++#++@@                            
=+=%@:                -@%++++++@@                                                                             @@@@                               
@@.                @@*++++++@@                                                                                                                   
                @@++++++*@@                                                                                                                      
             @@++++++*@+                                                                                                                         
         :@@++++++%@:                                                                                                                            
        @@+++++@@.                                                                                                                               
