   @-                                            *@*++++++@+++++++@@.                                                                            
    @                                               -@#+++@++++@@                                                                                
     @.                                                :@%@+@@                                                                                   
      @%                                                                                                                                         
       :@                                                                                                                                        
         @                                                                                                                                       
          @                                                                                                                                      
           @.                                                                                                                                    
-           @@                                                                                                                                   
#@           .@                                               @*##.                                                                              
++@            @                                            @=@*%=@                                                                              
+++@            @                                          .+#=*==@                                                                              
++++@.           @.                                       +=+=@%@+=*%                                                                            
+++++@@           %@                                     @=@@     -@*@=@                                                                         
+++++++@           .@                                   @@           :@#@                                                                        
++++++++@            @                               @@                 .@#                                                                      
+++++++++@            @-      :                   @@                       .@@                                                                   
++++++++++@*        =   *@=*=%*#+              #@                             .@@                                                                
=@#++++++++*@    -         @@=#=-            @@                                  .@@                                                             
   .@@+++++++@..              @@.            @++@@                                   @@                                                          
       @@+@@                 @@@             @+++++@@                                   @@                                                       
@ -%=+#@@                 @@+++@             .@@+++@@                                      @@                                                    
=%%=@@                .@@++++++@                @@                                            @@                                                 
+@#                #@*++++++@@.             .@@                                                  @@                                              
                @@+++++++@@              :@*                  @@.                                   @@                                           
              *@*+++++@@              +@-                 .@@+*++*@@                                   @@                                        
@                @@@* @@@=@@@*-@%-@%@.                 +@#++++@++++++@@.                                  @@.                                    
++@@                @@=#+====#*=@@                  @@+++++%@: @@*++++++*@@                                  @@=@@ @@=  @=                       
+++++@@                @@+===@@                  @@+++++@@.       .@@+++++++@@                                  @@=+=====@.                      
%+++++++@@                @@                 .@@+++++@@               @@+++++++%@*                                 %@+=+=*                       
 .@@+++++++@%                             =@#+++++@@                     =@%+++++++@@                                 *@=@                       
     @@++++++*@+                       @@*+++++@@                            @@+++++++@@-                              -@@                       
        @@*+++++#@                  @@++++++@@                                  #@*+++++++@@                        *@*++@                       
           =@@@.                .@@+++++*@*                                        .@@+++++++@@.                 @@*+++++@                       
          @@                 -@%+++++#@-                                               @@*++++++*@@           @@++++++@@                         
       @@                 @@*+++++@@.                                                     :@@+++++++@@.    @@++++++@@                            
   .@@                 @@++++++@@                                                             @@+++++++#@@++++++@@                               
:@%                .@@++++++@@                                                                   *@%++++@++++@@                                  
                :@%++++++@@                                                                          @@+@*@@                                     
             %@*++++++@@                                                                                -                                        
          @@++++++*@%                                                                                                                            
       @@++++++*@+                                                                                                                               
   :@@++++++%@:                                                                                                                                  
#@*++++++@@.                                                                                                                                     
