                @@++++++@@   -@*++++++@            @.                                                  =                                         
                   @@*+++++@#++++++@*++@.           @#                                                                                           
 @@.                  .@@++++++#@@ +#+++@@           :@                                                                                          
    #@.                   @@@@     =#++++*@            @                                                                                         
       =@=                         :#++++++@            @                                                                                        
          .@%                      :%+++++++@            @.                                                                                      
          :@%@                     :%++++++++@+           @@                                               @%=@                                  
       *@*+++@                     :%+++++++++*@           .@                                            @=%%*+@                                 
    @@+++++++@                     :@+++++++++++@            @                                          ==+=%==@                                 
 @@++++++*@@                       .@++++++++++++@            @                                        -==+@@@=+=:                               
++++++#@=                          .@+++++++++++++@:           @:                                     @=@@     @@=#@*                            
+++@@.                              @++++++++++++++%@           #@                                   @@           @@=+                           
@@                                  @@+++++++++++++++@           .@                               @@                 @@.                         
                                      .@@+++++++++++++@            @                           #@.                      @@.                      
                                          @@+++++++++++@.        :   @@+++@+#.              -@:                            *@:                   
                                             @@+++++++++@%    ..        @@===.            @%                                  +@:                
                                                %@*++++++*@..             .@+.            @+*@+                                  =@-             
                                                   =@#+@@                 @@@             @++++*@*                                  -@=          
                                         ==+.@ :@+..@@                 @@+++@             @@#+++@@                                     :@*       
                                         ==%#=++=@@                .@@++++++@                @@                                           .@%    
                                         ==@==@@                -@%++++++%@:              @@                                                 .@@ 
                                         ==@@                %@*++++++@@.              @@                  @@                                   .
                                        -@@                @@++++++@@              .@#                  @@+%++@@:                                
                                        :@+*@*                @@@@ @-@=@@@..@@.@=@-                 .@@++++@+++++*@@                             
                                         @++++*@=                @@=@+=##=+==%@.                 #@*++++*@*.@@+++++++@@.                         
                                         @+++++++#@:                @@*===@@                  @@+++++%@:       @@*++++++*@@                      
                                           @@+++++++#@.               .@@                  @@+++++@@.             .@@+++++++@@                   
                                              #@#++++++@@.                             .@@+++++@@.                    @@*++++++#@%               
                                                 .@@++++++@@                        +@#+++++@@                           -@@+++++++@@            
                                                     @@++++++@@                  @@++++++@@                                  @@+++++++@@=        
=@.                   *@=                               @@#@+                 @@++++++@@                                        #@#+++++++@@     
=+@               *+=#==*@                             @@.                .@@+++++*@#                                               @@+++++++@@: 
@#=%@             ==#======@                        @@.                +@#+++++#@=                                                     @@*++++++*
   @@=@@@=@    @*=====@@=#=@                     @@                 @@++++++@@.                                                           .@@++++
      @@==%=@@++*==@@    @@=*==@@            .@@                 @@++++++@@.                                                                  @@+
         @@+=@=%@-          @@=*#===@-@%@=+@#                .@@++++++@@                                                                         
            .@                 .@@=*=*=@@:                =@#++++++@@                                                                            
                                   @@@.                @@*++++++@@                                                                               
                                                    @@++++++*@@                                                                                  
                                                .@@++++++*@+                                                                                     
                                             -@%++++++%@:                                                                                        
                                              .@@++@@.                                                                                           
                                                 .@@                                                                                             
                                                    .@#                                                                                          
