                                @@++++++*@*  +@#+++++++@@                                                                                        
                                   @@++++++**++++++#@+                                                                                           
                                      @@++++*+++@@.                                                                                              
                                         @@+*@@                                                                                                  
                                                                                                                                                 
                                                                                                                                                 
                                                                                                                                                 
                                                                                                                                                 
                                                                                                                                                 
                                                                                                                                                 
                                               @===@                                                                                             
@-                                           @=%==@+                                                                                             
 +@                                          @+==#==:                                                                                            
   @                                        @=+@@@@=*@                                                                                           
    @                                     .=@@      @@==@:                                                                                       
     @                                   @@            @@@                                                                                       
      @=                              %@.                 @@                                                                                     
       =@      .:                  =@.                       @@.                                                                                 
     ..   @@+=*%=@              .@=                             @@.                                                                              
   .        .@#==@            -@:                                  @@.                                                                           
:              =@@            @++#@:                                  *@.                                                                        
              *@*@            @+++++*@-                                  =@:                                                                     
           @@++++@             @@*++@@                                      -@-                                                                  
        @@++++++*@               @@                                            :@=                                                               
    :@@++++++#@-              @@                                                  :@+                                                            
 %@*++++++@@.             .@@                  @@@                                   .@%                                                         
@@+++++@@              .@@                  @@++@++@@:                                  .@@                                                      
   @@@ .@@==@@@.@*-@@@*                 .@@+++++++++++*@@                                  .@@                                                   
     .@@=@==@=%==#@-                 =@#++++*@% .@@+++++++@@.                                 .@@#@@.@@. :@=                                     
        .@%=%=@@.                 @@+++++#@=        @@*++++++*@@                                  @@=@=====@                                     
           .@                  @@+++++%@.              .@@+++++++@@                                  @@=#==*                                     
                           .@@+++++@@.                     @@+++++++%@#                                 @@=.                                     
@                       =@#+++++@@                            -@%+++++++@@                               @@                                      
++@                  @@*+++++@@                                   @@+++++++@@-                       .@@++@                                      
*                 @@++++++@@                                         #@#+++++++@@                 :@%+++++@                                      
              .@@++++++@@                                               .@@+++++++@@.          +@*+++++%@:                                       
           -@%+++++*@#                                                      @@*++++++*@@    %@*+++++@@.                                          
        @@*+++++#@-                                                            :@@+++++++@@++++++@@                                              
     @@++++++@@.                                                                   @@+++++++++@@                                                 
 .@@++++++@@.                                                                         *@%++@@                                                    
%++++++@@                                                                                                                                        
++++@@                                                                                                                                           
+@@                                                                                                                                              
                                                                                                                                                 
