@@                                           @@+++++++@@*++++++#@+                                                                               
@.                                              @@+++++#++++@@.                                                                                  
 @#                                                #@*+#+@@                                                                                      
  :@                                                  +@                                                                                         
    @                                                                                                                                            
     @                                                                                                                                           
      @.                                                                                                                                         
       @@                                                                                                                                        
        .@                                                                                                                                       
          @                                               .+=@+                                                                                  
           @                                             %=+=%+                                                                                  
.           @.                                          @=+===%                                                                                  
@@           %@                                        @==#@@=+=@                                                                                
+*@           .@                                      @=@@    @@#*#@                                                                             
+++@            @                                    @@          %@=@                                                                            
++++@            @                                @@                *@:                                                                          
+++++@=           @:                           %@                      =@-                                                                       
++++++#@         :. @@@@=@@*@               =@.                           -@=                                                                    
++++++++@     ..       @@===@             @=                                 :@+                                                                 
@*+++++++@  .             @%@            #**@@                                  .@*                                                              
  :@%++@@.                @@@            @+++++@@                                  .@@                                                           
@@  @@                 @@+++@            *@#++++@@                                    .@@                                                        
=@@                 @@++++++@                @@                                          .@@                                                     
                :@@++++++%@-              @@                                                 @@                                                  
             %@*++++++@@              .@@                  @                                    @@                                               
           @+++++++@@              .@@                  @@+@+@@=                                   @@                                            
             @@*@@ ..#@.#@  @%..-@+                 .@@++++*+++++@@                                   @@                                         
                @@=@=+@%@@===%@:                 +@#++++*@*@@+++++++@@:                                  @@=@   =                                
*@*                @@==@==@@.                 @@+++++%@-      %@#++++++*@@                                  @@=@====@=@                          
+++*@=                @@@                  @@+++++@@.            .@@+++++++@@.                                 @@=*===@                          
++++++#@:                              .@@+++++@@                    @@*++++++*@@                                 @@==-                          
.@@++++++%@.                        +@#+++++@@                          :@@+++++++@@                                .@:                          
    @@++++++%@                   @@++++++@@                                 @@+++++++%@*                         .@%+@                           
       @@*#@+                 @@++++++@@                                       +@%+++++++@@                   =@#++++@                           
       @@.                .@@+++++*@%                                              @@+++++++@@-            #@*+++++@@.                           
    @@                 -@#+++++#@=                                                    @@*+++++++@@      @@*+++++@@                               
 @@                 @@*+++++%@:                                                          .@@+++++++@@@@++++++@@                                  
                 @@++++++@@.                                                                 @@*+++++*++++@@                                     
              @@++++++@@                                                                        -@@++*+@@                                        
          -@%++++++@@                                                                               @@                                           
       @@*++++++@@                                                                                                                               
    @@+++++++@@                                                                                                                                  
.@@++++++*@#                                                                                                                                     
++++++#@-                                                                                                                                        
