                           =@#++++++@@    :@%+++++++@@                                                                                           
                              :@%++++++@@*++++++*@%                                                                                              
                                 .@@++++@++++%@:                                                                                                 
                                    .@@+@+@@                                                                                                     
                                        @                                                                                                        
                                                                                                                                                 
                                                                                                                                                 
                                                                                                                                                 
                                                                                                                                                 
                                                                                                                                                 
                                            %*+@                                                                                                 
                                          @==%=%*                                                                                                
                                         @=#=#=*+                                                                                                
                                        -==%@@%=#=                                                                                               
@                                      @=@@    .@@+=@                                                                                            
 @.                                   @@           @@@                                                                                           
  @*                               %@.                @@                                                                                         
   :@                           -@:                      @@                                                                                      
   . .@@@*@@%=               .@+                            @@                                                                                   
.       #@=@=%             @%                                  @@                                                                                
           @@*             @+@@                                   @@                                                                             
           =@@            :@++++@@                                   @@                                                                          
        @@*++@             @@++++@@.                                    @@                                                                       
     @@++++++@                @@                                           @@                                                                    
 .@@++++++*@%              @@                                                 @@.                                                                
%++++++@@.              @@                  @=                                   @@.                                                             
++++@@               @@                  @@+@++@@                                   @@.                                                          
*@@ - @@%#@  %@.:.@@                 .@@++++@+++++@@.                                  %@.                                                       
 +@=+=%=*@==+=%@+                 :@%++++*@@#@#++++++*@@                                  *@=@.  @.                                              
    #@=@+==#@:                 %@*++++*@*      .@@+++++++@@.                                 =@+*=*==@%@                                         
       @@@.                 @@+++++#@-             @@*++++++#@@                                 -@*%*==@                                         
                         @@+++++@@.                   :@@+++++++@@                                 :@*=@                                         
                     :@@+++++@@.                          @@+++++++%@+                                @@                                         
                  %@*+++++@@                                 +@%+++++++@@                         .@@++@                                         
               @@++++++@@                                        @@+++++++@@-                  .@%++++*#                                         
            @@++++++@@                                              @@*++++++*@@            -@#+++++#@-                                          
        .@@+++++*@%                                                    .@@+++++++@@.     *@*+++++@@.                                             
     *@*+++++#@=                                                           @@*++++++*@@@*+++++@@                                                 
  @@++++++%@:                                                                 -@@+++++@++++@@                                                    
@++++++@@.                                                                        @@++@+@@                                                       
++++@@                                                                               *@                                                          
+@@                                                                                                                                              
                                                                                                                                                 
                                                                                                                                                 
