                                                                                                                                                 
                                                                                                                                                 
                                                                                                                                                 
                                                                                                                                                 
                                                                                                                                                 
                                                                                                                                                 
                                             @%%@@.                                                                                              
                                           @####@###@ .@@=                                                                                       
                                          @#####@####@%==+@                                                                                      
                                         @######@#####@==+@:                                                                                     
                                         @######%######@+#=%.                                                                                    
                                         @#############@ @@=@-                                                                                   
                                         @##############    @@                                                                                   
                                         @#####@#######%       @@.                                                                               
                                         @#####@#######@          @@.                                                                            
                                         @@####@#######@             =@=                                                                         
                                       @@    @#%#######@                .@%                                                                      
                                      @         @######@                    @@                                                                   
                                    .@             @###@                       @@                                                                
                                   @*                 @@                          @@                                                             
###%-                             @                  @*@+@@                          @@.                                                         
#####@                          -@                 .@++#++++@@                          %@:                                                      
######-                        @:                 @#+++@@++++++@@                          -@+                                                   
######*                       @                  @+++++@  @@++++++@@   @@@@@                  .@@                                                
######*                     %@                 @%++++++@     %@*+++++@#####@#%-                   @@            @@.                              
#######   .                @                  @++++++++@        =@#+@######@###@                     @@      @@@==@                              
####### @==@              @                 @@+++++++++@           .@######@####@                       @@==%=====@                              
######@====*@           @%                 @+++++++++++@            @######@#####@                         @@=====@                              
######%@@. @@@         @                 @@++++++++++++@            %######%######@                           +@+=*                              
%###@@        @@.    :@                 @++++++++++++++@           @%#############@                             #@.                              
@@:              :@@@:                #@++++++++++++++*@        @@  ##############@                          @@++@                               
                     -               @+++++++++++++*@=         .@+@@##############@                      .@@+++++@                               
                        % .        +@+++++++++++*@=            @*++++@@###########@                   *@#++++++%@-                               
                           :.     @++++++++++*@=               .@@++++++*@@#######@                @@+++++++@@.                                  
                               -:@+++@#@@=#@=                      @@+++++++@@####@             @@+++++++@@                                      
                                  @@@#=+=@.                           @@+++++++@@#@         -@%+++++++@@                                         
                                     .@@+@.                              @@+++++++#@#    @@*++++++*@%                                            
                                         @@                                 #@*+++++++@@+++++++%@-                                               
:                                     @@+*@                                    :@@++++*+++++@@.                                                  
+*@+                               @@++++##                                       .@@+*++@@                                                      
++++*@%                         @@+++++++@-                                           @@                                                         
@+++++++@@                  .@@+++++++@@                                                                                                         
  @@+++++++@@            -@#+++++++@@                                                                                                            
     @@*++++++@@      @@*++++++*@@                                                                                                               
