                                                                                                                                                 
                                                                                                                                                 
                                                                                                                                                 
                                        @#@###@                                                                                                  
                                      @###@####%                                                                                                 
                                     @####@######                                                                                       #@##%%@. 
                                    @#####@#####@                                                                                      @####@###@
                                   @######@#####@                                                                                     @#####@####
                                   #######@#####@                                                                                    @######@####
                                   #######@#####@=@                                                                                  @######%####
                                   #######@#####@==#=                                                                                @###########
                                   #######@#####@%==@@                                                                               @#####%#####
                                   #######@#####@=@==*-.                                                                             @#####@#####
                                  .#######@##@:   @@=+=@@                                                                            @#####@#####
                                  .#######@          *@+%                                                                           -@:@###@#####
      @*=@                        .###@=                :@#                                                                        @:    .@%#####
     :=++=%                       :@                       .@@                                                                    @         .@###
    @+@==#+@                       @=@.                        @@                                                               %@              @
   @%======@.                      @   #@.                        @@                       *@@-                                @                 
 :==@#=@@=*+=.                     @      @@.                        @@.                 @#%####@                            .@                  
 @==@@    @@=@                      .@@      @@                         +@-            @###%#####%                          @#                 %@
=@@          @@.                        @@      @@                         .@%        @###########@                        @                  @++
                *@:                        @@      @@                          @@    @############@                      :@                 +@+++
                   -@+          .             @@ @@                               @@ #############@                     @:                 @+++++
                      .@@=@@=@@=#===@ .@-    =@*                                    @#############@  .@                @                 -@++++++
                          @@=%=#=#===#==%=@@.                                       @#############@ @%##             *@                 @++++++++
                             @@==%==@==@@                        .@.                @#######%#####@%===+@@          @                 .@+++++++++
                                @@=*@#                        :@%+@+%@-             @#######%#####@@%  :@@         @                 @*++++++++++
                                                           @@*++++@++++*@@          @#######@###@          @@    @@                .@++++++++++++
                                                        @@++++++#@@#+++++++@@       @#######@@                @@@                 @#+++++++++++++
                                                     @@++++++#@:    .@@+++++++@@    @####@:                      :.              @+++++++++++++@@
                                                 .@@++++++#@:           @@+++++++@@.@#@                              +         @#+++++++++++@@   
                                                -@#++++%@.                 #@#++++@@.                                   %     @++++++++++@@      
                                                   .@@.                       .@@                                          .@@+++@@@@=@@         
                                                      .@@                      @++@@                                           @@=%===-          
                                                          @@@@@==@=            @+++++@@                                           @@#=-          
-                                                            @@=+++            =@#++++++@@                                          .@@          
+*@@                                                            @@+               :@%++++++@@                                    :@@++@          
+++++@@                                                         @@@                  .@@++++++@@.                             *@#++++*#          
@*++++++@@.                                                  @@+++@.                    .@@++++++%@.                       @@*+++++++@-          
  -@%++++++%@-                                            @@++++++@.                        @@++++++#@-                 @@+++++++#@+             
      @@++++++*@@                                     -@%++++++@@.                             @@++++++*@*           @@+++++++@@.                
         @@*++++++@@                               @  @++++%@*                                    @@+++++++@@    .@@+++++++@@                    
            .@@++++++@@                        -.      @@@                                           @@+++++++@@%+++++++@@                       
