                                                                                                                                                 
                                                                                                                                                 
                                                                                                                                                 
                                                                                                                                                 
                                                                                                                                                 
                                                                                                                                                 
                                                                   @#####@@                                                                      
                                                                  @####@####-@+=@                                                                
                                                                 @#####@#####+=+=@                                                               
                                                                @######@#####@+%#=@=                                                             
                                                                @######@######%@+*=@                                                             
                                                                @##############. @@=%@                                                           
                                                                @##############.    @@                                                           
                                                                @#####%########        @@.                                                       
                                                                @#####@#######%           +@-                                                    
                                                               =@ @###@#######@              :@*                                                 
                                                              @.     @@#######@                 .@@                                              
                                                             @          @#####@                     @@                                           
                                                           @@              @%#@                        @@                                        
                      @@@@                                @                  @@@                          @@.                                    
.@@                 @######@                            .@                  @+@++@@                          @@.                                 
    @@            @##########                          @*                 @@++@+++++@@                          =@=                              
       @@        @###########@                        @                  @++++@@@++++++@@                          .@@                           
          @@.   @############@                      -@                 #@+++++@   @@*+++++@@ @%###@@                   @@                        
             #@:#############@                     @:                 @+++++++@      +@#++++######@##@                    @@           ==@       
               @#######%#####@  =@.               @                 =@++++++++@         :@%@######@####:                     @@  @:#==@==@       
               @#######%#####@ @+=@.            %@                 @++++++++++@            @######@#####+                       @@=@=====@       
               @#######@#####@%=+@#=@.         @                 :@+++++++++++@            @######@######                          #@+==+@       
@@             @#######@#####@@:   @@        .@                 @*++++++++++++@            @######@######@                            -@*@       
+++@@          @#######@##%@          #@=   @%                .@++++++++++++++@          @@@######@######%                            =@@.       
++++++@@.      @#######@+                .@@                 @*++++++++++++++@@        @@  @######%######%                         @@+++@        
@@*++++++#@-   @####@.                       *             .@+++++++++++++@@          .@++@@#############@                      @@++++++@        
   -@%++++++*@%@%@                              *         @#+++++++++++@@             =#+++++#@%#########@                  :@@++++++*@@         
       @@++++@@                                    ..    @++++++*+++@@                  @@+++++++@@######@               @@*++++++%@-            
          @@                                           @@#++@%@*#@@                        @@+++++++@@###@            @@+++++++@@.               
          @*+@@.                                          -@@*===@                            @@+++++++@@@        .@@+++++++@@                   
          @+++++@@.                                           @@=@                               @@*++++++*@@  #@#+++++++@@                      
           @@++++++%@:                                         :@@                                  -@#+++++++*++++++*@@                         
              @@++++++#@+                                   #@*++@                                     .@@++++*+++%@-                            
                 @@++++++*@%                             @@++++++@                                         @@+*@@.                               
                    @@+++++++@@                       @@+++++++*@-                                                                               
                       @@+++++++@@                 @@+++++++@@.                                                                                  
                          %@*++++++@@          .@@+++++++@@                                                                                      
                             *@*++++++@@    -@%+++++++@@                                                                                         
