                                                                                                                                                 
                                                                                                                                                 
                                                                                                                                                 
           @@@@                                                                                                                                  
        %##@####%                                                                                                                                
       @###%#####@                                                                                         @@@@                                  
     .#####%#####@                                                                                       @####@##@   @-                          
     @###########%                                                                                      @###########*#+@                         
    @#############                                                                                     @###########@=@=%.                        
    @#############=@                                                                                   ######@######@#=+=@                       
    @#############=%=@                                                                                 ######@#######.@@=#@                      
    @#############=*==+.                                                                               ######@#######@   @@@                     
    @#############@*=+=:                                                                               ######@#######@      @@.                  
    @###########@.+@@====                                                                              ##############@         @@.               
    @#######%@       .@@=@@                                                                           :@#############-            *@:            
    @####@:             .@@                                                                          @-   @#@########:               -@*         
    @#@                     @@                                                                      @        @#######.                  .@@      
    @@@                        @@                                                                 *@            @####                       @@   
    @  .@%                        %@.                                                            @.                @%                          @@
    @     :@=                        -@=                   @#@##%@                              @                  @#+@@                         
     @@      -@:                        .@@              @###@####%                           @@                 =@+@++++@@                      
        @@      *@.                        .@@          @####@#####@                         @                  @+++@@++++++@@                   
           @@      @@                          @@      @#####@#####@                       .@                 :@++++@  @@++++++@@    =@@#        
              @@.  .@@                            @@. *######@#####@                      @=                 @*+++++@     @@++++++@@######%*     
:=*@@@          @@:                                  #%######@#####@                     @                 .@+++++++@        *@*++%#########@    
==+=#+=**=@@@@@                                      .#######@#####@  @+=@             +@                 @*++++++++@           :@############.  
=@=#%=#@==@@                                         .#######@#####@@=*%@=+           @.                .@++++++++++@            =######%######. 
@@@=*=@@:                        @@**@@              .#######@#####@=@@-@@=%         @                 @#+++++++++++@            +######@######@ 
   *@                         @@+++*++++@@           .#######@####%@.      @@      @@                 @+++++++++++++@            @######@#######*
                           @@++++++%+++++++@@        .#######%#@*             +@* @                 @%++++++++++++++@         @@ @######@#######+
                       .@@++++++@@   @@+++++++@@.    .######@.                   :.                @+++++++++++++*@%         @+@@@######@#######:
                    =@#++++++@@         @@*++++++%@- .###@                           # .         @@+++++++++++*@@            @++++@@####@#######.
                 .@*++++++@@               -@@++++++*@@                                 =       @++++++++++*@#               @%++++++#@@@####### 
                    @@+@@                      @@*@@                                        : #@+++++#*@*@#                     @@+++++++@@##### 
                       @@                        @@@                                           @@@@===#@                           @@+++++++@@## 
                          @@  % @@.@@            @+++@@                                           -@@=@@                              @@+++++++%@
                             @@==@==@            @++++++@@.                                           @@                                 @@*+++++
                                @@==@              @@++++++@@.                                      #@*@                                    =@#++
                                   @@                 @@++++++#@-                                @@++++@                                       .@
                                @@++@                    @@++++++*@*                          @@+++++++@                                         
                            :@@+++++@                       @@++++++*@@                   .@@+++++++@@.                                          
                         @@*++++++@@                           @@+++++++@@             .@@+++++++@@                                              
                       @++++++@@=                                 @@+++++++@@       =@#+++++++@@                                                 
                  =.    @+*@@                                        #@*++++++@@ @@*++++++*@#                                                    
