                                                                                                                                                 
                                                                                                                                                 
                                                                                                                                                 
                                              #%@###@.                                                                                           
                                            -###@#####@                                                                                          
                                           @####@#####@                                                                                       .@#
                                          @#####@#####@                                                                                      @###
                                         =######@#####@                                                                                     @####
                                         @######@#####%-                                                                                   .#####
                                         @######%######=@                                                                                  .#####
                                         @#############===@                                                                                .#####
                                         @#############=+*++.                                                                              .#####
                                         @############@@=+=%@*                                                                             .#####
                                         @#########@=    @@=@=@#                                                                           .#####
                                         @######@           @@=.                                                                           @ @%##
            @*##@                        @##@#                 @@.                                                                       #@     @
           .@#@=@                        @                        *@:                                                                   @        
           **=@=@#                       @ @@                        :@*                                                              .@         
         .%===%@=*@                      @    @@                        .@@                      #@@@                                @#          
        @=*==@@@=@=@                     @.      @@                         @@                 @##%###%:                            @            
       @=#@@    .@@=.                      @@.      @@                         @@            +####%#####+                         :@             
      @@@           @@                        *@:     .@%                         @@.       @#####@#####@                        @:              
    @@                 @@                        =@-     :@                          +@-   .######@#####@                       @                
 @@                       @@.         @             :@+@@                               .@#@######@#####@                     *@                 
                             @@+*@#=@%=====..@@    :@%                                    :#######@#####@   @+               @.                 @
                                +@+=%=@====*==@=@@.                                       :#######@#####@ @%@@+            .@                 @@+
                                   :@#=%#=@=@@@                         @@                :#######@#####@%==@+=@%         @%                 @+++
                                      .@@+@%                        .@@+*++@@             -#######@#####@@@   @@.        @                 @@++++
                                                                 +@#++++%+++++@@.         =#######@###@          :@@   .@                 @++++++
                                                              @@*+++++*@@@+++++++%@=      +#######@@                 @@-                #@+++++++
                                                           @@++++++*@+     +@#++++++*@@   +####@=                       @              @+++++++++
                                                        @@++++++*@=           .@@+++++++@@*#@.                             :         =@++++++++++
                                                       @@++++#@-                  @@++++@@.                                    +    @++++++*+++@@
                                                          @@-                        @@.                                          :@@++@*@+@@@   
*                                                            @@.        .             @+%@:                                          .@@====@    
++@@                                                            *@+=@@%=*@           .@++++#@=                                           @@=@    
+++++@@                                                            -@*==@#            @@++++++*@#                                          @@    
@+++++++@@.                                                           .@%=               @@+++++++@@                                   .@@++@    
  #@#++++++*@#                                                        #@#@                  %@*++++++@@                             -@%+++++@    
     .@@+++++++@@                                                  @@++++@                     #@*++++++@@                       #@*+++++++@@    
         @@+++++++@@                                            @@++++++*@                        =@*++++++@@                 @@+++++++*@@       
            -@@++++++@@.                                    :@@++++++@@                              :@#++++++@@.          @@+++++++%@-          
                @@++++++*@*                              @  @*+++#@@                                    .@%++++++@@.    @@+++++++@@.             
@.                 %@*++++++@@                       :.      *@@.                                          .@@++++++%@@+++++++@@                 
