                                                                                                                                                 
                                                                                                                                                 
                                                                                                                                                 
   +@@@                                                                                                                                          
 @#######-                                                                                                                                       
##########.                                                                                         @%+                                          
##########.                                                                                      #####@##@   .-                                  
####%#####:                                                                                     @#####@####@=#=@                                 
####%######                                                                                    @######@######==%-                                
####@#####@@.                                                                                  @############@==@==.                              
####@#####@#*@                                                                                 @#############@@@=@@                              
####@#####@#==@%                                                                               @#####@#######@   @@%                             
####@#####@====@                                                                               @#####@#######@      @@                           
####@###%@=@*=#==@                                                                             @#####@#######@         @@.                       
####@@=      .@%=%*                                                                            @#####@#######@            #@:                    
##@              @@                                                                          .@   @##########@               -@+                 
                    @@                                                                      @*       @#######@                  .@@              
                       @@.                                                                 @            @####@                     .@@           
@@                        %@.                                                            :@                @%*                         @@        
  .@+                        -@+                   .@@##%@                              @:                 %@#@@                          @@     
     -@:                        .@@               @##@#####-                           @                  @++*+++@@                          %@. 
@@      +@.                         @@          @####@#####%                         %@                 +@+++@++++++@@                          +
   @@      @@                          @@      *#####@######.                       @.                 @++++#. @@++++++@@     .+:                
      @@    @@:                           @@.  %#####%######.                     .@                 :@+++++%.    %@*+++++@@#####@%@             
         @@                                  #@######%######.                    @#                 @*++++++%-       +@*++@######@###.           
=@@:@#@@                                      @#############. @==@              @                 .@++++++++%=          :@@######%####@          
*=@@:                                         @#############@#%#*=@           :@                 @*+++++++++#*            %######%#####@         
@                         @@@@#               @#############=+@@@@=@         @-                .@+++++++++++*#            ##############         
                      .@@+++@+++@@            @############@@      @@.      @                 @#++++++++++++*%           .##############@        
                   :@%++++++#++++++@@         @#########@.            +@+ *@                .@++++++++++++++*@        +@*.##############@        
                #@*++++++@@  @@+++++++@@.     @#####%@                   ..                @%+++++++++++++@@.        =#@@.######%#######@        
             @@+++++++@@        @@*++++++%@-  @##@*                          @            @++++++++++++@@.           @++++@@####%#######@        
          @@+++++++@@              -@%++++++*@@.                                =       @@++++++++++@@.              @%++++++#@%@#######@        
            @@++@@                    .@@+@@.                                      .:  @+++++*@@+@@.                   .@@+++++++@@#####@        
               @@                        @@@                                           @@@%==#**                           @@+++++++@@##*        
                  @@  = .=..@            @+++@@                                           -@@=@=                              @@+++++++%@=      @
                     @@@=@==@            @++++++@@.                                          .@@                                 @@*++++++*@@@@++
                        @@==@              @@++++++%@.                                       @@%-                                   =@#+++++#++++
                           %@                 @@++++++#@=                                 @@+++@.                                      .@@++%+++@
                        +@#+@                    @@++++++*@%                          .@@++++++@                                           @@@%  
                     @@*++++@                       @@+++++++@@                    =@#+++++++@@                                                  
                  @@++++++#@@                          @@+++++++@@              %@*+++++++@@                                                     
               @@++++++@@.                                @@+++++++@@        @@+++++++#@+                                                        
           @    @*+#@#                                       #@*++++++@@  @@+++++++@@.                                                           
