                                                                                                                                                 
                                                                                                                                                 
                                                                                                                                                 
                                                                                                                                                 
                                                                                                                                                 
                                                                                                                                                 
                                                 @@##@@                                                                                          
                                                %####%###- @@@                                                                                   
                                              .###########@%%=@                                                                                  
                                              #############=@==@                                                                                 
                                              ######@######@%*==@                                                                                
                                              ######@#######=:@%=@:                                                                              
                                              ######@#######@   .@@                                                                              
                                              ######%#######@       @@                                                                           
                                              ##############@          @@                                                                        
                                             @=@############-             @@.                                                                    
                                            @    .@@########.                %@.                                                                 
                                          +@         @######.                   =@=                                                              
                                         @.             @###                       .@%                                                           
    ...                                 @                  @=                         .@@                                                        
 .%#@###@                             @@                 :@#+*@=                          @@                                                     
@###@#####*                          @                  @*+@++++*@=                          @@                                                  
####@#####@                        .@                 .@+++@@@+++++*@-                          @@.                                              
####@#####@                       @=                 @*++++@   @@+++++*@=  #@%#@=                  #@:                                           
####@#####@                      @                 .@++++++@      @@+++++@########@                   -@*           @@@                          
####@#####@   =                =@                 @#+++++++@         @@++###########=                    .@@  .  @@@===-                         
####@#####@ :=@=@             @.                 @+++++++++@            -############@                       @@==%=%==+.                         
####@#####@@#=%=#%           @                 @@++++++++++@            +######%######*                         @@==#==                          
####@#####@#@* :@@.        @@                 @++++++++++++@            #######@######%                            @@=#                          
####@####@         @@     @                 @@+++++++++++++@           #@######@########                            .@@                          
####%@@               %@:@                 @+++++++++++++++@        @@  @######@#######=                         #@#++@                          
##@:                                     %@+++++++++++++@@          @++@@######@#######:                      @@+++++*%                          
                             +          @++++++++++++@@             @+++++@@###@#######.                   @@+++++++@@                           
                                #     +@++++++++++@@                #@*++++++%@@#######.               =@#++++++*@*                              
                                   . @++++@#@=@@@                      -@%++++++*@@####             @@+++++++%@:                                 
                                       @@%*===@                           .@@+++++++@@#         .@@+++++++@@.                                    
                                          *@#=@                               @@+++++++@@.   :@%+++++++@@                                        
@@                                           :@                                  @@+++++++*@*+++++++@@                                           
+++@@                                     :@%+@                                     %@*++++@++++*@#                                              
++++++@@.                              *@*++++@                                        =@#+@+%@:                                                 
.@@++++++@@.                        @@++++++++@                                           .@.                                                    
    @@++++++#@-                  @@+++++++#@+                                                                                                    
       @@++++++*@*            @@+++++++@@.                                                                                                       
          @@+++++++@@     .@@+++++++@@                                                                                                           
