                                                                                                                                                 
                                                                                                                                                 
                                                                                                                                                 
                                                                                                                                                 
                                                                                                                                                 
                                                                                                                                                 
                                       -@@@@.                                                                                                    
                                      %#######@  -@@                                                                                             
                                    .###########+#%=@                                                                                            
                                   .######@#####@=+=@*                                                                                           
                                   :######@######%*==%@                                                                                          
                                   :######@####### @@==*                                                                                         
                                   :######@#######%   @@+                                                                                        
                                   :##############+      @@.                                                                                     
                                   :##############.         =@=                                                                                  
                                   @@####%########.            .@%                                                                               
                                  @    @#@########                .@@                                                                            
                                -@        @%######                    @@                                                                         
                               @.            @%##%                       @@                                                                      
                              @                 #@                          @@.                                                                  
                            %@                 .@@+@@                          *@:                                                               
                           @                  @*+@++++@@                          -@+                                                            
@                        .@                 .@+++@@*+++++@@                          .@@                                                         
@                       @*                 @#++++@  *@*+++++@@   .@@@@                   @@                                                      
@                      @                  @++++++@     -@#+++++@########@                   @@            @@.                                    
@   .                :@                 @%+++++++@        .@@++######%###@                     @@      @@.===.                                   
@ -=@=-             @:                 @+++++++++@           .@######%#####.                      @@@====%==#                                    
@*@=#++            @                 @@++++++++++@            @######@######                         *@++=+=@                                    
@=@@ @@=.        #@                 @++++++++++++@            @######@######@                           :@%=@                                    
.       %@=     @.                %@+++++++++++++@           .@######@#######.                             @@                                    
           .@@.@                 @+++++++++++++++@        @@. @######@#######.                         .@@+*#                                    
               .               +@+++++++++++++@@          @+@@@######@#######                       #@#++++@.                                    
                  * :         @++++++++++++@@             @++++#@%###@#######                    @@+++++++@@                                     
                     ..     -@++++++++++@@                @@+++++++@@@######%                .@@+++++++@@                                        
                         % @+++**+@=@@@                      @@+++++++@@####%             =@#++++++*@@                                           
                            =@@@===@@                           @@+++++++@@%@          @@+++++++#@-                                              
                                @@=#@                              #@*++++++*@@     @@+++++++@@.                                                 
                                   @@                                 -@%+++++++@@%+++++++@@                                                     
                                .@@+@                                    .@@+++++@+++++@@                                                        
                             .@@++++@                                        @@++@+*@%                                                           
@                         =@#+++++++@                                           @@-                                                              
++@@                   @@*+++++++@@                                                                                                              
+++++@@             @@+++++++*@+                                                                                                                 
@#++++++@@       @@+++++++@@.                                                                                                                    
