                                                                                                                                                 
                                                                                                                                                 
                                                                                                                                                 
                                           -@@###@.                                                                                              
                                         .###@#####@                                                                                             
                                        @####@#####@                                                                                        @###@
                                       @#####%#####@                                                                                      =######
                                      .######%#####%                                                                                     @#######
                                      @######%######:                                                                                    ######%#
                                      @#############=@                                                                                   ######@#
                                      @#############==+@                                                                                 ######@#
                                      @#############===*=:                                                                               ######@#
                                      @############%@===#@-                                                                              ########
                                      @#########@@    @@=@=@=                                                                            ########
                                      @######@.          @@=-                                                                           @ @###%##
         @%+%@                        @##%@                 @@.                                                                       :@     @@##
         @+@=@                        @:                       @@:                                                                   @:         @
        =@*@=@+                       @ @@                        -@+                                                               @            
       @===%#=*@                      @    @@                        .@@                      :@@@                                #@             
     @====@@#=@=@                     @       @@                         @@                 @##@###%:                            @.              
    @=%@@    .@@=-                      %@.     .@@                         @@            .####@#####@                         .@                
   @@@           @@                        #@.     .@+                         @@.       ######@#####@                        @#                 
 @@                 @@                        +@:     :@.                         %@:    ######@#####@                       @                  @
                       @@          @             =@-@@                               :@#@######@#####@                     :@                 @@+
                          @@#*@*=@@===+=: @@     @@                                    .#######@#####@   @=               @:                 @+++
                             %@==#=%==*====%=#@+                                       .#######@#####@ @@%@%             @                 %@++++
                                =@*=**+#+@@@.                        @@                .#######@#####@@==@==@@         *@                 @++++++
                                   .@%+@@                         @@+*++@@             .#######@#####@@@   @@.        @.                +@+++++++
                                                              .@@++++*+++++@@.         .#######@###@.         -@%    @                 @+++++++++
                                                           +@#++++++@@@+++++++%@:      :#######@@                 @@%                :@++++++++++
                                                        @@*++++++@@     %@#++++++*@#   :####@@                       @              @*+++++++++++
                                                     @@+++++++@@           .@@+++++++@@:#@:                             -         .@+++++++++++@@
                                                    @@++++*@%                  @@++++%@=                                    =    @*+++++*+++@@.  
                                                       @@@                        @@                                            @%++#@@+#@@.     
                                                          %@.                      @+@@.                                          .@@+===@       
@                                                            #@:=@@@+%@           .@++++#@-                                           @@=@       
++@@                                                            =@+==@@            @@++++++*@*                                          @@       
+++++@@.                                                           :@#%               @@++++++*@@                                    @@++@       
@*++++++#@+                                                        :@@@                  @@+++++++@@                             .@@+++++@       
  .@@+++++++@@                                                  %@*+++@                     %@*++++++@@                       :@%+++++++@@       
      @@+++++++@@                                            @@++++++*@                        +@*++++++@@                 #@*+++++++@@          
         =@%++++++@@.                                     @@++++++@@:                             -@#++++++@@           @@+++++++*@%             
            .@@++++++#@+                              +. @#+++*@@                                    :@%++++++@@.    @@+++++++@@:                
                @@*++++++@@                       .-      =@@.                                          .@@++++++%@@+++++++@@                    
