                                                                                                                                                 
                                                                                                                                                 
                                                                                                                                                 
                                                                                                                                                 
                                                                                                                                                 
                                                                                                                                                 
                                                            .@####@-                                                                             
                                                           @#########:@@#@                                                                       
                                                          @#####@#####*===@                                                                      
                                                         *######@#####@=+@=@.                                                                    
                                                         *######@######@%#+=@                                                                    
                                                         *######@#######. @@=@@                                                                  
                                                         *##############:    @@                                                                  
                                                         *##############.       @@                                                               
                                                         *#####%########           @@.                                                           
                                                         @ @###@########              *@:                                                        
                                                       @@     @@#######%                 :@*                                                     
                                                      @          @#####@                    .@@                                                  
                                                    .@              @##@                        @@                                               
               =@@*                                @=                 :@@                          @@                                            
             @######@                             @                  @*@++@@                          @@.                                        
           ###########.                         -@                 .@++@+++++@@                          @@.                                     
@@        @###########@                        @.                 @*+++@@@++++++@%                          +@-                                  
   @@    -######%#####@                       @                 .@+++++@   @@++++++@@ .@###@@                  :@@                               
      @@.@######%#####@                     @@                 @#++++++@      @@*++++@#####@##@                    @@           @*@              
        @#######@#####@   @.               @.                .@++++++++@         *@*#######@####:                     @@  @..#+@==+              
        @#######@#####@ @@#*.            .@                 @%+++++++++@            @######@#####*                       @@=*+====@              
        @#######@#####@*==#%+@.         @*                 @+++++++++++@            @######@######.                         @@%===@              
        @#######@#####@@@  .@@         @                 @@++++++++++++@            @######@######@                            %@=@              
        @#######@###@.         @@.   :@                 @++++++++++++++@          :@@######@#######                             @@*              
@       @#######@@                :@@:                @@++++++++++++++@@        @@  @######@#######                         :@@++@.              
++@@.   @####@#                      .-              @+++++++++++++@@.          @++@@######@######%                      @@*+++++@               
+++++#@-@#@.                             @         *@+++++++++++@@              @+++++@@##########%                   @@+++++++@@                
@@++++@@:                                   :     @++++++++++@@                 :@%++++++*@@######@               .@@+++++++@@                   
   @@                                           +@*++@@@@=@@                        @@+++++++@@###@            #@#++++++*@#                      
   =%+@@                                           @@*@===@                            @@+++++++@@@         @@+++++++%@-                         
   #*++++@@                                           .@@=@                               @@+++++++#@*  .@@+++++++@@.                            
   .@@++++++@@.                                          @@                                  %@*+++++++@+++++++@@                                
       @@++++++@@.                                    @@++@                                     -@%++++#++++@@                                   
          @@++++++#@-                             .@@+++++@                                        .@@+**@%                                      
             @@++++++*@*                       =@#+++++++@@                                            -                                         
                @@++++++*@@                 @@*+++++++@@                                                                                         
                   @@+++++++@@           @@+++++++#@+                                                                                            
                      @@+++++++@@     @@+++++++@@.                                                                                               
