                                                                                                                                                 
                                                                                                                                                 
                                                                                                                                                 
                                             .@####%#                                                                                            
                                            @########@                                                                                           
                                          @###########                                                                                        @##
                                         %############                                                                                      .####
                                         #############                                                                                     -#####
                                        @#############*                                                                                    ######
                                        @#############==                                                                                   ######
                                        @##############*=@.                                                                                ######
                                        @###############==*@                                                                               ######
                                        @############%@=#==@*                                                                              ######
                                        @#######%#@@    @@=#=@@                                                                            ######
                                        @######@:          @@=@                                                                           @.+@###
           @@==@                        @##%@                 +@-                                                                       .@     -@
           @+%=#                        @-                       .@%                                                                   @#        
          %%++=**.                      @.@@                         @@                                                               @          
         @==@*===@                      @.   @@                         @@                      .@@@.                               :@           
       @==+=@@@=*=@.                    @-      @@                         @@.                @##@####@                            @:            
      @=*@@     @@=@                      :@+      @@                         @@.            %###@#####@                          @              
     @@@           @@                        .@#      @@                         =@=       .#####@######                        #@               
   @@                 @@.                       .@@      @*                         .@@    %#####@######                       @.                
@@                       #@:         #.            .@@@@.                               @@@######@######                      @                 =
                            -@@=@%=@@===@=@ @@.   .@@                                     #######@######   @@               @@                 @+
                               .@@=@=%==@@=+@#=+@#                                        #######@###### -@=#@             @                 :@++
                                  .@@==@@*=+@@.                        @@                 #######@######@%=@==@@         .@                 @*+++
                                      @@@@@                         @@++*+@@.             #######%######@@   +@*        @-                .@+++++
                                                                .@@++++++++++#@-          ###########@-          @@    @                 @*++++++
                                                             -@%++++++@@@*++++++*@%       ########@                 @@@                 @++++++++
                                                          @@*++++++@@     .@@+++++++@@    ####%@                       =              @#+++++++++
                                                       @@+++++++@@            @@+++++++@@ #@-                             .:         @+++++++++++
                                                      %@*++++@@                  @@*+++#@*                                    @    @%+++++#+++%@.
                                                         +@@                        -@-                                           @@+++*@=%@@.   
                                                            :@+                      @+*@*                                           @@==+=@     
+@@                                                            .@%=@@+=@@            @+++++@@                                           @@*@     
++++@@.                                                            @@==*@            %@*++++++@@                                          @@     
*++++++#@+                                                            @@@               *@*++++++@@                                    @@++@     
 :@@+++++++@@                                                        .@@@                  =@#++++++@@                             .@@+++++@     
     @@+++++++@@                                                  *@#+++@                     :@%++++++@@                       .@@+++++++@@     
        %@#++++++@@.                                           @@+++++++@                        .@@++++++@@.                +@#+++++++@@        
           .@@++++++#@*                                     @@++++++@@=                             .@@++++++%@:          @@*++++++*@%           
               @@*++++++@@                              -  +@++++@@                                     @@++++++*@=    @@+++++++%@-              
:                 -@@++++++@@                        =       @@:                                           @@++++++*@@+++++++@@.                 
