                                                                                                                                                 
                                                                                                                                                 
                                                                                                                                                 
                              :@@##@:                                                                                                            
                            %###@####@                                                                                                           
                           @####@#####*                                                                                       .@##%@*            
                          @#####@#####@                                                                                      @####@###@ :@*@     
                         @######@#####@                                                                                     @#####@####%+===@    
                         #######@#####@                                                                                    @######@#####@==*%%   
                         #######@#####@=@                                                                                  @######%######%@*=%.  
                         #######@#####@=+=                                                                                 @#############@ @@=#@ 
                         #######@#####@==@%@                                                                               @##############    @@.
                         #######@#####@===%@                                                                               @#####@#######%       
                        .#######@##%@   @@=@=@.                                                                            @#####@#######@       
                        .#######@:         @@=%                                                                            @@%###@#######@       
                        .####@                @@.                                                                        @@    @%@#######@       
@                       :@+                      @@:                                                                    @         @@#####@       
=@                       @@@                        -@+                                                               .@             *@##@       
*@                       @   @@                        .@@                        :.                                 @-                 +@       
@%=                      @      @@                         @@                  @#@####@                             @                  @*@+@@    
@@=@                      %@.     .@@                         @@             @###%#####@                          +@                 .@++%++++@@ 
   @@                        *@.     .@*                         @@         @###########@                        @.                 @*+++@@*+++++
      @@                        +@:     .@=                         %@:    %############@                       @                 .@+++++@  -@#++
         @@                        -@= @@.                             :@# #############@                     @@                 @#++++++@     .@
            @@=#@+=@#*+=*=@  .      @@                                    @#############@   =                @                  @++++++++@       
               %@%=+=*=*%#==#=+@=@@                                       @#############@ @+*#             .@                 @%+++++++++@       
                  -@*==+=====@@:                        *                 @#############@====+@:          @=                 @+++++++++++@       
                     .@%==@@                         @@+@+@@              @#######%#####@@@  @@@         @                 @@++++++++++++@       
                        .                        .@@++++@++++@@.          @#######@###@=        =@%    -@                 @++++++++++++++@       
                                              :@%++++++@@+++++++%@:       @#######@@                @@@.                @@++++++++++++++%@       
                                           #@*++++++@@    @@*++++++*@#    @####%@                      %               @+++++++++++++%@.         
                                        @@+++++++@@          .@@+++++++@@ @#@+                            - .        #@+++++++++++%@.            
                                      @@++++++@@                 @@+++++*@%                                   -     @++++++++++%@.               
                                         @@@@                       @@@.                                         :+@+++@@@@=@@.                  
                                            %@.                      @+%@.                                          .@@@===+-                    
                                               *@:@@++@@+            @++++#@-                                           @@=+-                    
                                                  =@*==%+            @@++++++*@*                                           @@                    
                                                     :@#+               @@++++++*@@                                     @@++@                    
                                                      .@@                  @@+++++++@@                               @@++++*%                    
                                                   +@#++@.                    %@*++++++@@                        .@@+++++++@=                    
+@@                                             @@++++++@.                       +@*++++++@@                  -@#+++++++@@                       
++++@@.                                      @@++++++%@#                            -@#++++++@@            %@*++++++*@@                          
@++++++#@+                               ...@+++++@@                                   .@%++++++@@.     @@+++++++#@+                             
  @@*++++++@@                         #      @@@=                                         .@@++++++%@@@+++++++@@.                                
