                                                                                                                                                 
                                                                                                                                                 
                                                                                                                                                 
                                                                                                                                                 
                                                                                                                                                 
                                                                                                                                                 
                                                      =@##%@@                                                                                    
                                                     @####@###@ %@=@                                                                             
                                                    @#####@####%====@                                                                            
                                                   @######@#####@==++@                                                                           
                                                   @#############+##=*.                                                                          
                                                   @#############@ @@=*@.                                                                        
                                                   @#####%########    +@-                                                                        
                                                   @#####@#######%       :@%                                                                     
                                                   @#####@#######@          .@@                                                                  
                                                  .@@@###@#######@              @@                                                               
                                                 @-    *@%#######@                 @@                                                            
                                                @         =@#####@                    @@                                                         
                                              +@             :@##@                       %@.                                                     
         :+=                                 @.                 *@                          =@=                                                  
       @#@####@                             @                  @+@+@@                          .@#                                               
     @###%#####@                          @@                 +@++#++++@@                          .@@                                            
    @############                        @                  @++++%@#+++++@@                           @@                                         
   @############*                      .@                 -@+++++@  .@@+++++@@. .@###@.                  @@                                      
@@ ##############                     @+                 @*++++++@      @@+++++%#####@##@                   @@.          .=@%                    
  @#############%   @                @                 .@++++++++@         @@+@######@###@                     *@:  = -=@@==@                    
  @#############% @%%@             =@                 @*+++++++++@            @######@####%                       -@#=##====@                    
  @#############@+====@*          @.                .@+++++++++++@            @######@#####@                         .@@==@=@                    
  @#######%#####@@@  @@@         @                 @*++++++++++++@            %######%######@                            @@=+                    
  @#######@###@.        .@@    @@                 @++++++++++++++@          :@%#############@                             @@                     
  @#######@@                @@@                 @%++++++++++++++@@        @.  ##############@                         :@@++@                     
  @####@%                      %               @+++++++++++++@@          .@+#@%#############@                      %@*+++++@                     
@ @#@.                            ..         @@+++++++++++@@.            @*+++++@@##########@                   @@+++++++@@                      
@@:                                   *     @++++++++++@@                 @@+++++++@@#######@               .@@+++++++@@                         
                                         .@@+++@@@@=@@                       @@+++++++@@%###@            *@#++++++*@@                            
@=                                           @@*=+==:                           +@*++++++*@@@         @@+++++++%@-                               
++*@*                                           @@+=:                              :@@+++++++@@    @@+++++++@@.                                  
++++++@@                                           @@                                 .@@+++++++@%+++++++@@                                      
%@*++++++@@                                     @@+*@                                     @@++++*+++++@@                                         
   *@*++++++@@                              .@@++++#*                                        @@+*+*@@                                            
      =@#++++++@@                        +@#+++++++@:                                           %-                                               
         :@%++++++@@                  @@*++++++*@@                                                                                               
            .@%++++++@@.           @@+++++++#@=                                                                                                  
               .@@++++++%@:     @@+++++++@@.                                                                                                     
