                                                                                                                                                 
                                                                                                                                                 
                                                                                                                                                 
                        -@###@                                                                                                                   
                      @########@                                                                                                                 
                     @##########                                                                                        :@#%@@                   
                    %###########.                                                                                      @####@###% .@@.           
                   @############.                                                                                     @#####@####@#==@:          
                  :#############-                                                                                    @############+===@          
                  :#######%#####*=.                                                                                  @############@%=*=*         
                  +#######%#####@*#@                                                                                 @#####%#######@.@@=@.       
                  ########@#####@=*++@                                                                               @#####@#######@    @@       
                  %#######@#####@@===@                                                                               @#####@#######@       @@    
                  %#######@##%@  %@=+==*                                                                             @#####@#######@          @@ 
                  @#######@-        =@*=@                                                                           :@@############@             
                  @####@               .@%                                                                         @:   .@#########@             
                  @@+                      @@                                                                     @         @######@             
                  ++@=                        @@                                                                *@             @###=             
                  *-  =@:                        @@.                                                           @.                 @*             
                  #:     *@.                        #@:                  @#@###@                              @                  @+**@+          
                    @@      @@                         -@+             @###@#####@                          @%                 *@++++++*@+       
                       @@      @@                         .@@         @####@######                         @                  @+++#@@+++++*@+    
@-                        @@      @@                          @@     @#####@######.                      .@                 -@++++@   @@+++++*@= 
  .@#                        @@  %@.                             @@ :######@######.                     @-                 @++++++@.     @@+++++*
     .@@@@+=@*@=@=@=@         @@                                    @######@######.                    @                 :@+++++++@.        @@*+@
         @@=@=@==%#@==#=%@=@@                                       @######%######. %==@             +@                 @*++++++++@:           +%
            @@+=@=%=+*=@@:                        .                 %#############@+===#@           @.                .@++++++++++%:            #
               @@=*=@@                         @@+@#@=              %#############=@@ :@@@         @                 @*+++++++++++%-            #
                  +                         @@++++#+++*@%           %###########@=        @@     @@                 @+++++++++++++#-           @#
                                        :@%++++++@%+++++++@@        %########@.              %@-@                 @#++++++++++++++%=       .@* -#
                                     %@*++++++@@    @@+++++++@@     %####%@                      .               @+++++++++++++%@.         @*+@@#
                                  @@+++++++@@          @@+++++++@@. %#@+                            +          @@+++++++++++%@.            @+++++
                                @%++++++@@                *@#+++++*@#                                  #      @++++++++++@@.               *@*+++
                                  .@@@@                      .@@@.                                        . @@+++@*@@=%@.                     :@%
                                     .@@                       @+@@                                           @@@+=@=#                           
                                         @@ @@@@@@@            @++++@@                                           *@%%%                           
                                            @@==%=@            @%++++++@@                                           .@.                          
                                               @@=@              .@@++++++@@.                                     @@+@.                          
                                                .@@                  @@++++++@@.                               @@++++@                           
                                             +@#++@                     @@++++++%@:                        .@@+++++++@                           
                                          @@++++++@                        @@++++++#@+                  -@#+++++++@@                             
                                       @@++++++#@#                            @@++++++*@@            @@*++++++*@@                                
+@@                                ..@#+++++@@                                   @@+++++++@@      @@+++++++#@+                                   
++++@@.                         #     +@@@+                                         @@+++++++@@@@+++++++@@.                                      
