                                                                                                                                                 
                                                                                                                                                 
                                                                                                                                                 
                                    @@###@                                                                                                       
                                  @##@#####@                                                                                                     
                                #####%#####@                                                                                        @###@@:      
                               @#####%#####@                                                                                      .##########.@#@
                               #############                                                                                     -###########@@%=
                              @#############                                                                                     ######%######=%=
                              @#############=#                                                                                   ######@######@#%
                              @#############=+@@                                                                                 ######@######## 
                              @#############%==%=:                                                                               ######@#######@ 
                              @#############+#==%@                                                                               ######%#######@ 
                              @##########@   -@#=+=@.                                                                            ############### 
                              @######@#         .@@=@                                                                           @ @############: 
 -@=@:                        @###@.                @@                                                                         @     @@########. 
 @=#=@                        @@                       @@                                                                    @@         @######. 
++@%#++                       @ @@                        @@.                                                               @              @###  
#=+@+=@*                      @   .@*                        *@:                       **-                                .@                  @@ 
@=+@==+=@                     @      :@-                        :@#                 ###@###@.                            @-                 #@%++
@-   +@+=%                      @@      =@.                        .@@             @###@#####@                          @                  @++@++
        :@*                        @@      %@.                         @@        :#####@#####@                        +@                 =@+++@@@
           .@@                        @@      @@                          @@     %#####@#####@                       @.                 @+++++@  
               @@          .             @@ =@*                              @@.@######@#####@                      @                 :@++++++@  
                  @@@@@=+@@===#=. *:     @@.                                    #######@#####@   @.               @@                 @*+++++++@  
                     @@=+=+===@+=@==#=@@                                        #######@#####@ +=%+@             @                 .@+++++++++@  
                        @@==*=*=@@*@*                        +=                 #######@#####@@+=@==@.         .@                 @*++++++++++@  
                           %@=*@@.                        @@*++*@@              #######@#####@@@.  @@.        @+                .@++++++++++++@  
                                                       @@++++*+++++@@          .#######@###@@         @@.    @                 @#+++++++++++++@  
                                                    @@++++++@@@+++++++@@       .#######%@:               :@@@                 @++++++++++++++*@  
                                                :@@++++++@@     @@+++++++@@.   .#####@                       -              @%++++++++++++*@#    
                                             #@*++++++@@           #@*++++++#@=.#%@                             @          @+++++++++++*@*       
                                            @@+++++@@                 .@@+++++@@                                   :     @@+++++++++*@*          
                                               @@@                        @@*                                           @*++*@@@=@@#             
                                                  @@                       @+@@                                           #@#@===@               
                                                     @@.*@@#@@@            @++++@@.                                          .@@=@               
                                                        @@===+@            @@++++++@@.                                          +@               
                                                           @@=@               @@++++++%@:                                    @@*+@               
@@.                                                         @@@                  @@++++++#@+                              @@+++++@               
+++%@=                                                  .@@+++@                     @@++++++*@%                        @@+++++++%@               
++++++*@@                                            +@#++++++@                        @@+++++++@@                 .@@+++++++@@.                 
 @@*++++++@@                                      @@++++++*@@                             @@+++++++@@           :@%+++++++@@                     
    -@@++++++@@.                               = @*++++@@.                                   @@*++++++@@     *@*++++++*@@                        
        @@++++++%@=                        @      @@@@                                          #@*++++++@@@*++++++#@=                           
