                                                                                                                                                 
                                                                                                                                                 
                                                                                                                                                 
                                                                                                                                                 
                                                                                                                                                 
                                                                                                                                                 
                                      .@@@@=                                                                                                     
                                     @####@##%.  @@                                                                                              
                                    @##########@@+=@                                                                                             
                                   @############=#==@                                                                                            
                                   ######%######@@==@@                                                                                           
                                   ######@#######=@@==@                                                                                          
                                   ######@#######@   *@@                                                                                         
                                   ######@#######@      -@+                                                                                      
                                   ######%#######@         .@@                                                                                   
                                  -@%############@             @@                                                                                
                                 @.   %@%########+                @@                                                                             
                                @        *@######:                   @@                                                                          
                              @@            -@###.                      @@.                                                                      
                             @                 :@                          +@-                                                                   
                           .@                  @++@@                          :@#                                                                
                          @*                 #@+#++++@@                          .@@                                                             
                         @                  @+++@@#+++++@@                           @@                                                          
                       :@                 +@++++@  :@@+++++@@    @@@@                   @@                                                       
                      @:                 @++++++@     .@@+++++@%#####%#@                   @@.           %@.                                     
                     @                 -@+++++++@         @@++@##########:                    %@.     =@-%==@                                    
  %==@             %@                 @*++++++++@            @############@                      =@@==#=+==@:                                    
@+=*=#*           @.                .@++++++++++@            .##############                        .@%==#==.                                    
=@@ @@=%         @                 @*+++++++++++@            :######%######%                           .@@==                                     
       :@@     @#                .@+++++++++++++@            @######%#######@                             @@                                     
           @@ @                 @#++++++++++++++@.       .@@ %######@#######%                          @@++@                                     
                               @+++++++++++++#@:         @+%@@######@#######*                      .@@+++++@                                     
                 : :         @%+++++++++++#@:            @++++*@@###@#######=                   #@*++++++@@.                                     
                     +      @++++++++++%@:               @@+++++++@@@#######.                @@+++++++@@                                         
                        % @@+++#+@#@#@:                     @@+++++++@@#####.            .@@+++++++@@                                            
                           .@@@==+*@                           #@*++++++*@@#          +@#+++++++@@                                               
                               @@=+@                              :@%+++++++@@     @@+++++++*@*                                                  
                                  @@                                  @@+++++++@@@+++++++@@.                                                     
                                @@+@                                     @@+++++@+++++@@                                                         
                             @@++++@                                        @@++@++@@                                                            
                          @@+++++++@                                           @@@                                                               
+@@                   :@@+++++++@@                                                                                                               
++++@@.            *@*+++++++@@                                                                                                                  
@++++++%@:      @@*++++++*@#                                                                                                                     
