                                                                                                                                                 
                                                                                                                                                 
                                                                                                                                                 
                  @@#@@                                                                                                                          
               -%#######@                                                                                                                        
              @####%#####.                                                                                        @@@@%                          
             @#####%#####-                                                                                      @####@####  @@                   
            @######%#####=                                                                                     @#####@####@#==@.                 
           .#######@#####@                                                                                    @######@#####%===@                 
           .#######@#####@==                                                                                  @############@*=@*=.               
           .#######@#####@=*+                                                                                 @#############@+@*=@               
           .#######@#####@+@=@@                                                                               @#####@#######%   .@@              
           :#######@#####@%=*=@                                                                               @#####@#######@       @@           
           =#######@###@. @@=%==@                                                                             @#####@#######@          @@        
           ########@@        %@==@                                                                            @@####@#######@             @@     
           @####@:              =@=                                                                         %@   :@#########@                @@  
           @#@                     .@%                                                                     @.       .@######@                   %
           .@@.                        @@                                                                .@            .@###@                    
           .@  @@.                        @@                                                            @%                 @*                    
           .%     @@                         @@.                  @#@###@                              @                  @*##@:                 
            .@%      @@                         #@:             +###@#####@                          :@                  @++*+++#@:              
               .@%      @@                         -@+         @####@######.                        @-                 @#+++@@+++++#@.           
                   @@      @@                         .@@     @#####@######.                       @                  @++++#:  @@+++++%@.   %@@@.
                      @@  .@@                             @@  ######%######.                     *@                 @@+++++#-     @@+++++%@#####@
*@@-@@-.@**@@@         #@-                                   @#############.                    @.                 @+++++++#+        @@++@######@
 .@@*#=#==%=*=+#=@@#@@                                       @#############. @==@             .@                 @@++++++++#*           @@######@
     @@@=#=@==@==@@                                          @#############@====@@           @@                 @++++++++++*#            %######%
        @@===%@-                        %@*@@@.              @#############=%@-*@#@         @                 %@+++++++++++*@            ########
           @                         @@++++@+++#@=           @############@.      .@@     .@                 @++++++++++++++@           @########
                                  @@++++++@#++++++*@@        @########@*              @@.@-                +@+++++++++++++++@        @@ .########
                              .@@++++++@@.  .@@+++++++@@     @#####@.                                     @++++++++++++++@@         =#*@@########
                           :@%++++++@@          @@+++++++@@  @##@                           .:          -@++++++++++++@@            @+++++@@###%#
                         @#++++++@@                @@*++++++@@                                  @      @+++++++++++@@               @@+++++++@@@#
                           -@#@@                      =@%@@                                        = .@+++%+@@=+@@                     #@*++++++#
                              .@#                       @*@@                                           @@@==#=+.                          :@%++++
                                 .@@ @-:@@=@            @++++@@                                           @@+%+.                             .@@+
                                     @@==@=@            @*++++++@@                                           +@:                                 
                                        @@=@              =@#++++++@@                                      +@*%=                                 
                                          @@                 :@%++++++@@                                @@*+++@.                                 
                                       @@++@                    .@@++++++@@.                         @@+++++++@.                                 
                                   :@@+++++@                       .@@++++++@@.                   @@+++++++%@:                                   
                                @@*++++++@@                            @@++++++#@=            .@@+++++++@@.                                      
                             *@#+++++@@=                                  @@++++++*@*      :@%+++++++@@                                          
                         =     +@+@@                                         @@++++++*@@*@*++++++*@@                                             
