                                                                                                                                                 
                                                                                                                                                 
                                                                                                                                                 
                                                                                                                                                 
                                                                                                                                                 
                                                                                                                                                 
                                                                                  @######@                                                       
                                                                                 @####@####@%==@                                                 
                                                                                @#####@#####@@*=@                                                
                                                                               @######@#####%*=+==@                                              
                                                                               @######@######@@*%+@                                              
                                                                               @##############. .@%=@                                            
                                                                               @##############.    .@@                                           
@@                                                                             @#####%########         @@                                        
%=+@                                                                           @#####@########            @@                                     
=@@                                                                           @+ .@##@#######@               @@.                                 
   .@@                                                                       @      .@#######@                  *@:                              
       @@                                                                  -@          .@####@                     -@+                           
          @@                                                              @.               @#@                        .@@                        
             @@.                    :@##@=                               @                  @@@-                          @@                     
                @@:               +########+                           #@                 .@+@++*@=                          @@                  
                   -@*           @##########.                         @.                 @*++@+++++*@-                          @@               
                      .@@       @###########@                       .@                 .@++++@ @@+++++*@-                          @@.           
                          @@   @############@                      @#                 @*+++++@    @@+++++*@-@####@@-                  *@-        
                             @@#######%#####@                     @                  @+++++++@       @@++++######@###-                   :@%     
                              @#######%#####@  @*@              :@                 @#++++++++@          @@@######@####@                     .@@ @
                              @#######@#####@@@===@            @:                 @++++++++++@            @######@#####@                        @
           @@@.               @#######@#####@==@@#==.         @                 @@+++++++++++@            @######@######:                        
       .@@++@++#@+            @#######@#####@@    .@@       *@                 @+++++++++++++@            @######@######@                        
    :@%+++++@+++++*@@         @#######@##@.           @@.  @.                @@++++++++++++++@         =@%@######@#######                        
 @@*++++++@@:@@+++++++@@      @#######@                  +@                 @++++++++++++++@@:        @@@ @######%######%                        
+++++++@@       @@+++++++@@   @###@*                        ..            %@++++++++++++@@.           @+++@@############@                     %@*
+++*@#             @@+++++++@@@@.                               @        @+++++++++++@@.             -#++++++@@#########@                  @@++++
*@#                   =@#++@@:                                     =   +@++++++@++@@                   +@*++++++#@%#####@              .@@+++++++
%                        =@%                                           @@++@=#==@.                        .@%+++++++@@##@           #@*++++++*@@ 
  @@        @            %*++@@                                           @@#@==@                             @@+++++++@@        @@+++++++%@-    
     @@==*==#.           @++++++@@                                           =@@@                                @@+++++++@@-.@@+++++++@@.       
        @@===             -@#++++++@@                                         @@@                                   @@+++++++*++++++@@           
           @@                .@@++++++@@                                   @@+++@                                      #@*+++*+++@@              
         =@#@.                  .@@++++++@@.                           .@@++++++@                                         :@%*@@                 
      @@*+++#+                     .@@++++++%@:                     =@#+++++++@@                                                                 
   @@++++++*@-                         @@++++++#@=               @@*++++++*@@                                                                    
@@++++++@@.                               @@++++++*@#         @@+++++++#@=                                                                       
@#++#@%                                      @@+++++++@@   @@+++++++@@.                                                                          
