                                                                                                                                                 
                                                                                                                                                 
                                                                                                                                                 
                                                                                                                                                 
                                                                                                                                                 
                                                                                                                                                 
                                                                          .####@#@.                                                              
                                                                         @#########@@+*#                                                         
                                                                        @###########@*@=+                                                        
                                                                        ######%######+#+==@                                                      
                                                                        ######@######@@*=+@                                                      
                                                                        ######@#######@ .@%=@                                                    
                                                                        ######@#######@     @@                                                   
                                                                        ##############@        @@                                                
                                                                        ##############+           @@                                             
                                                                       @ .@##%########:              @@.                                         
                                                                     @@     .@########.                 *@:                                      
@                                                                   @          .@#####                     -@*                                   
  @@                                                              .@               @##                        .@@                                
     @@                      @@@@=                               @+                 -@@+                          @@                             
        #@:                @##@####@                            @                  @+@++*@=                          @@                          
           -@*           #####@#####@                         =@                 .@++@+++++*@=                          @@                       
              .@@       @#####@#####@                        @.                 @*+++@ @@+++++*@=                          @@.                   
                  @@    ######@#####@                       @                 .@+++++@    @@+++++*@-*%####@+                  +@-                
                     @@@######@#####@                     %@                 @#++++++@       @@++++@#########@                   :@*          @=+
                      .#######@#####@  .@@               @                  @++++++++@          @@+###########@                     .@@ @@.*==%==
                      .#######@#####@.@=#=@            .@                 @%+++++++++@            -######%#####@                        @@==#====
   :@@.               .#######@#####@#+=@*=+@         @*                 @+++++++++++@            *######%######@                          @@==+*
#@*++++#@+            .#######@#####@@-   .@@        @                 @@++++++++++++@            @######@#######                             @@@
++++*+++++*@@         .#######@###@.          @@   -@                 @++++++++++++++@          @@@######@#######+                           -@%@
++%@:@@+++++++@@      .#######@*                 +@:                @@++++++++++++++@@        @@# @######@#######:                        @@*++*@
@.      @@+++++++@@.  .####@.                       ..             @+++++++++++++@@           @+++@@#####@#######.                     @@++++++%=
           @@+++++++@@:#@                               %        #@+++++++++++@@              @++++++@@##@#######                  .@@++++++*@@  
              =@%+++@@                                     +    @++++++@+++@@                  *@*++++++#@%######               #@*++++++#@=     
                  @@                                           @@++#=%=+@@                        .@@+++++++@@###            @@+++++++@@.        
    :             @++@@                                           @@=#==@                             @@+++++++@@        .@@+++++++@@            
*#@=%@            @+++++@@                                           +@@@                                @@+++++++@@- *@#+++++++@@               
@@===@            :@#++++++@@                                         .@@                                   @@+++++++@++++++*@@                  
   @@@               .@%++++++@@                                   +@#++@                                      #@*+++@+++#@=                     
  @@+@                  .@@++++++@@.                            @@*+++++@                                         :@@@@@.                        
@++++@                      @@++++++%@:                      @@+++++++*@#                                                                        
++++@@                         @@++++++*@+                @@+++++++%@:                                                                           
*@@                               @@++++++*@@         .@@+++++++@@.                                                                              
                                     @@+++++++@@   :@%+++++++@@                                                                                  
