                                                                                                                                                 
                                                                                                                                                 
                                                                                                                                                 
                                                                                                                                                 
                                                                                                                                                 
                                                                                                                                                 
                                         -@%@@*                                                                                                  
                                        @####%##%. :@@                                                                                           
                                       %##########@%*=@                                                                                          
                                      %############=@==@                                                                                         
                                      ######@######@@==%@                                                                                        
                                      ######@#######-@@==@                                                                                       
                                      ######@#######@   +@@                                                                                      
                                      ######@#######@      :@%                                                                                   
                                      ##############@         .@@                                                                                
                                     %@@############=             @@                                                                             
                                    @    +@@########:                @@                                                                          
                                  .@        =@######.                   @@                                                                       
                                 @*            :@###                       %@.                                                                   
                                @                 .@.                         -@=                                                                
@                             :@                  @*+@@                          .@%                                                             
##=                          @:                 @@+%++++@@.                         .@@                                                          
##@                         @                  @+++@@#+++++@@                           @@                                                       
##@                       #@                 @@++++@  .@@+++++@@.  .@@@@.                  @@                                                    
##@                      @                  @++++++@      @@+++++@########@                   @@.           @@:                                  
##@   .                 @                 %@+++++++@         @@++%##########.                    *@:     @@+*==+                                 
##@  ++=@             @#                 @+++++++++@            @#############                      -@@==#=%==@.                                 
##%@%=#=%-           @                 +@++++++++++@            -#############*                        .@@==@==                                  
##%=@@ @@+=        :@                 @++++++++++++@            =######@######%                            @@=*                                  
#@:       .@@     @-                -@+++++++++++++@           .@######@#######@                             @@                                  
              @@ @                 @+++++++++++++++@        -@- @######@#######*                         .@@++@                                  
                                 .@+++++++++++++@@.         @+#@@######@#######-                      +@%++++*@                                  
                    ...         @*+++++++++++@@.            @+++++@@###@#######.                   @@+++++++@@.                                  
                        +     .@++++++++++@@.               @@+++++++@@@#######.                @@+++++++@@                                      
                           # @#+++%+@+@@@                      @@+++++++@@#####             -@@+++++++@@                                         
                               @@@===+@                           +@*++++++*@@#          @@*++++++*@+                                            
                                  @@==@                              .@%+++++++@@     @@+++++++%@.                                               
                                     @@                                 .@@+++++++@@@+++++++@@                                                   
                                   @@+@                                     @@+++++@+++++@@                                                      
                               .@@++++@                                        @@++@++@@                                                         
+@@                         :@%+++++++@                                           #@*                                                            
++++@@                   *@*+++++++@@                                                                                                            
@++++++@@.            @@+++++++*@@                                                                                                               
 .@@++++++#@:      @@+++++++@@-                                                                                                                  
