                                                                                                                                                 
                                                                                                                                                 
                                                                                                                                                 
                                                                                                                                                 
#=                                                                                                                                               
##=                                                                                         :..                                                  
##@                                                                                       @###@##@    .                                          
##@                                                                                     .#####@####@===@                                         
##@                                                                                    .######@######=++@                                        
##@@.                                                                                  @######@#####@==*==@                                      
##@+@@                                                                                 @#############@@%=#@                                      
##@@==#@                                                                               @##############   @@=.                                    
##@=+==@                                                                               @#####%#######%      @@                                   
#@@@=#==+@                                                                             @#####@#######@         @@                                
     =@*+*=.                                                                           @#####@#######@            @@.                            
        .@@                                                                           @   @##@#######@               #@:                         
           .@@                                                                      .@      .@#######@                  -@*                      
               @@                                                                  @-           @####@                     .@@                   
                  @@                                                              @                @#@                         @@                
                     %@.                    @@##@@                              +@                  @@@@                          @@             
                        -@+               @##@#####=                           @.                 @%+%++*@#                          @@          
@@                         .@@           ###########                          @                  @+++@+++++*@#                          @@.      
   @@                          @@       #############                       @@                 @@++++@ @@+++++*@%                          +@-   
     @@                           @@   @############%                      @                  @++++++@    @@+++++*@*%####@%*                  :@#
 @@*                                 @@#############%                    .@                 %@+++++++@       @@+++@######@###.                   
.                                     @#############@ .@=@              @+                 @+++++++++@          *@@######@####@                  
                                      @#############%@=#==@            @                 *@++++++++++@            @######@#####@                 
                  =@@@=               @#############@=*@@@=*         =@                 @++++++++++++@            @######@######.                
               @@*++@++*@@            @#######%#####@.     @@       @.                =@+++++++++++++@            %######%######@                
            @@++++++@++++++@@         @#######@#@@            @@:  @                 @+++++++++++++++@         @@ ##############@                
         @@++++++@@..@@+++++++@@      @######@+                  .@                :@++++++++++++++@@         @@@ ##############@                
     .@@++++++@@        @@+++++++@@.  @###@                          =            @*++++++++++++@@           +%+++@@############@                
  *@*++++++@@              @@*++++++#@@@                                @       .@+++++++++++@@              @*++++++@@#########@                
    @@++@@                    .@@++@@                                      ..  @*+++++%@++@@                   :@%++++++*@@#####@              @@
       @@                        @@@                                           @@**@=+=+@                          @@+++++++@@##@           @@+++
          @@  .  .  @            @+++@@                                           @@@*+=:                             @@+++++++@@.      :@@++++++
             @@*=@==*            @++++++@@                                           .@@:                                @@+++++++#@%@@*++++++*@@
                @@@=*             .@@++++++@@                                        =@#@                                   @@*++++++++++++#@+   
                   @@                .@@++++++@@.                                 %@*++*@                                      -@%++*+++@@.      
                 @@+@                    @@++++++#@-                           @@++++++#+                                         .@@@@          
             .@@++++@.                      @@++++++*@+                     @@+++++++#@=                                                         
          +@#++++++@@                          @@++++++*@@              .@@+++++++@@.                                                            
       @@++++++#@@                                @@+++++++@@        .@@+++++++@@                                                                
   ..   @*++@@.                                      @@+++++++@@  +@#+++++++@@                                                                   
