@=                                                            @@.                        %@:                                          -@@++@=@=#@
++*@@                                                            +@:        +            @++#@=                                           @@%*==+
++++++@@                                                            -@@=+===#            @+++++*@#                                           @@=+
@@+++++++@@.                                                           .@%*=#             @@++++++*@@                                         @@@
   @@*++++++%@=                                                           .@@                %@*++++++@@                                   @@+++@
      -@%++++++*@@                                                       :@@@                   *@*++++++@@                             @@+++++*%
          @@+++++++@@                                                 %@*+++@.                     =@#++++++@@                      :@@+++++++@@ 
             %@*++++++@@.                                          @@++++++*@.                        :@%++++++@@                *@*+++++++@@    
                .@@++++++#@=                                    @@++++++@@:                              .@@++++++@@.         @@*++++++*@%       
@@                  @@++++++*@@                             *   @+++*@@                                     .@@++++++%@-   @@+++++++@@:          
   @@.                 =@%++++++@@                      .:       @@.                                            @@++++++*@+++++++@@              
      +@-                  @@++++++@@                @:           -@                                               @@++++@++++@@                 
         :@#                  %@*+++++%@-         @@++%@            @                                                 @@+@*@%                    
            .@@                  .@@+++++*@@   @@+++++++@            @                                                   :                       
                @@                   @@++++++@+++++++@+++@            @.                                                                         
                   @@                   +@%++@+++@@- @++++@.           @+                                                                        
                      @@                    @@@@     @+++++@%           -@                                                                       
                         @@.                         @++++++*@            @                                                                      
                            *@:                      @++++++++@            @                                                                     
                            @@*@                     @+++++++++@            @.                                               ===@                
                         @@++++@                     @++++++++++@=           @#                                           .==%#+#:               
                      @@++++++*@                     @+++++++++++#@           :@                                          @*==+=%:               
                  .@@++++++%@:                       @+++++++++++++@            @                                        @=**@@@=%+              
               *@#++++++@@                           @++++++++++++++@            @                                      @=@=     @@==@.          
            @@+++++++@@                              @+++++++++++++++@.           @.                                   @%           @@%          
@@@@@@#=.@@+++++++@@                                 -@*++++++++++++++@@           @%                               @@                 @@        
+++++++++*++++*@*                                       :@%+++++++++++++@           .@                           @@                       @@     
+++++++++#+%@:                                             .@@+++++++++++@         @   @@#=@@=#               @@                             @@  
.-#@@@@@@@.                                                    @@+++++++++@.    *        .@+*=%             @.                                  @
                                                                  @@+++++++@#=              #@%            .@+%@.                                
                                                                     @@*+@@                 @@@            #*++++%@.                             
                                                          @@+ %: @%#+.@@                .@@+++@             @@++++@@                             
                                                          %==#==@=+@*                =@#++++++@               .@@                                
                                                          %====#@:                @@*++++++@@              -@+                                   
                                                          *=@@.                @@+++++++@@              #@:                 .@@                  
                                                          @@:                @@+++++*@%              @@.                 -@%+@++@@.              
                                                          @++#@.               .@@@: @-=*@@@ =@@%@@@                  %@*++++@+++++#@%           
                                                          @+++++%@.               .@%=##=@=+@==@@                  @@+++++@@ .@@+++++++@@        
                                                          @@+++++++@@                .@**+==@@                  @@+++++@@        @@+++++++%@+    
                                                             @@+++++++@@                -@@                 :@@+++++@@              =@@+++++++@@ 
                                                                @@+++++++@@                              @@*+++++@@                     @@+++++++
                                                                   +@#++++++@@                        @@++++++@@                           @@#+++
                                                                      .@@++++++@%                  @@+++++*@*                                 .@@
               .=+=@                    @@:                               @@@@                 :@@+++++#@-                                       
