                                                                           =#######@#####@%==@                                                   
                                                                           +#######@#####@=+==@                                                  
                                                                           +#######@####@@@=+=+@#                                                
                                                                           %#######@#@.     @@=%=@                                               
                                                                           @#####%@            @@@                                               
                                              @===#%                       @##@:                  @@                                             
                                             =@*=+*.                       @@                        #@:                                         
                                             @#=====@                      -+ @@                        :@+                                      
                                            @==+@*===@                     -=    @@                        .@@                     %@#@@         
                                          @=@=%@@@@=@=@                    :@.      @@                         @@                @##@####@       
                                         @==@@     .@@@                       @@.     .@#                         @@           .####@#####@      
                                        =@@            @@                        %@.     .@+                         @@.      .#####@######.     
                                     .@@                  @@                        +@:     @@                          +@-   @#####@######.     
                                  .@@                        @@         @@.            -@@@                                :@@######%######.     
                               .@%                              @@=@=@=%*==+=@=@@@ ..#@=                                     @######%######.  @@=
                            .@#                                    *@==@=%=++@==+=@@                                         @#############.@@==@
                         .@#                                          -@#==@*==@@                        .@@@                @#############+#=@@=
                      :@*                                                .@@@=                        -@%++@++@@             @#############@+    
   .               :@=                                                                             @@*+++++#+++++@@.         @##########@.       
 @=@             -@.                                                                            @@++++++#@:@@+++++++%@-      @######@@           
 +=@              @+#@#                                                                      @@++++++#@:      +@#++++++*@@   @###@.              
@=+@              @+++++@@                                                               .@@++++++%@:            .@@+++++++@@@@                  
*==@              @++++++++@@                                                             @@+++%@.                   @@+++@@                     
*=@@@               +@#+++++++@@.                                                            @@.                        @@.                      
@     @@                @@+++++++*@*                                                            @@.        -            @++@@.                   
         @@                @@*+++++++@@                                                            #@%%====@            @+++++#@-                
            @@                :@@+++++++@@                                                            =@+*=@             @@++++++*@*             
               @@.                @@+++++++@@.                                                           :@@                @@++++++*@@          
                  =@-                #@#++++++*@#                                                       @@+@                   @@+++++++@@       
                     :@#                 @@+++++++@@                                                 @@++++@                      %@*++++++@@    
                        .@@                 @@*++++++@@                                          .@@++++++@@                         *@*++++++@@ 
                            @@                 -@@++++++@@.                                   +@#++++++@@                               -@#++++++
                               @@                  @@++++++*@*                             *   @+++@@-                                     :@%+++
                                  @@                  @@#++++++@@                      *        @@                                            .@@
                                     @@.                 .@@++++++@@               .@            @=                                              
                                        +@-                  @@++++++@@.         @@++@:           =@                                             
                                           :@#                  -@@+++++*@%   @@++++++#@            @                                            
                                              .@@                   @@++++++@++++++#@+++@            @                                           
                                                  @@                   @@*++@+++@@  @++++@            @.                                         
                                                     @@                   .@@@.     @+++++@.           @+                                        
                                                        @@                          @++++++@@           -@                                       
                                                           @@.                      @+++++++*@            @                                      
                                                           @@@                      @+++++++++@            @                                     
                                                       .@@+++%-                     @++++++++++@            @.                                   
