      @@++++++*@@                                    @@++++++*@@                               @@++++++*@*         :@%+++++++@@                  
         @@#++++++@@                             .:  @@+++@@.                                     @@++++++*@@   *@*++++++*@@                     
            .@@++++++@@.                      %       .@#                                            @@+++++++@+++++++#@+                        
                @@*+++++#@=               =@            @                                               @@++++@++++@@.                           
@                  -@@+++++*@@         =@*++@            @                                                 @@+@+@@                               
  @@                   @@++++++@@   -@#++++++@            @:                                                  -                                  
     @@                   @@#+++++@#++++++@*++@:           @@                                                                                    
        @@.                  .@@+++*++#@@ -%+++@@           .@                                                                                   
           *@:                   @@@@     :%+++++@            @                                                                                  
              -@+                         .@++++++@            @                                                                                 
                 .@@                      .@+++++++@.           @:                                                                               
                 :@@@                     .@++++++++@#           #@                                               @#+@                           
              *@*+++@                     .@+++++++++*@           .@                                            @=%#*=@                          
           @@+++++++@                     .@+++++++++++@            @                                          :=*=#==@                          
        @@++++++*@@                       .@++++++++++++@            @                                        -==+@@@=+==                        
    .@@++++++#@+                          .@+++++++++++++@-           @-                                     @=@@     @@=%@#                     
 -@%++++++@@.                              @++++++++++++++#@           *@                                   @@           %@=#                    
*++++++@@                                  @@+++++++++++++++@           .@                               @@                 @@.                  
++++@@                                       .@@+++++++++++++@            @.                          #@.                      #@.               
*@@                                              @@+++++++++++@.        ..  @@+*+@*%:              -@:                            +@:            
                                                    @@+++++++++@@    ..        @@===.            @@                                  -@-         
                                                       #@*++++++*@..             .@*.            @+*@%                                  -@+      
                                                          -@#+@@                 @@@             @++++*@#                                  :@+   
                                                ==*.@ .@+..@@                 @@+++@             @@#+++@@                                     .@#
                                                ==%#=+*=@@                 @@++++++@                @@                                           
                                                ==@==@@                :@@++++++%@:              @@                                              
                                                ==@%                %@*++++++@@.             .@@                  @@                             
                                               .@@                @@++++++@@              .@#                  @@+#++%@-                         
                                               .@++@#                @@@@ %=@=@@@:.@@.@-@=                 .@@++++@++++++@@                      
                                                @++++*@*                @@=@==##====%@.                 *@#++++*@# @@+++++++@@.                  
                                                @+++++++*@-                @@*===@@.                 @@+++++#@-       #@#++++++*@@               
                                                  @@+++++++#@:                @@                  @@+++++@@.             .@@+++++++@@.           
                                                     +@#++++++%@.                             .@@+++++@@.                    @@*++++++#@@        
                                                        .@@++++++@@.                       =@#+++++@@                           :@@+++++++@@     
                                                            @@++++++@@                  @@*+++++@@                                  @@+++++++%@* 
     #==@.                   +@+                               @@*@+                 @@++++++@@                                        *@%+++++++
   @=+@=+@.              ++=#=+#@                             @@.                .@@+++++*@@                                               @@++++
  @==@@@%=%@.            ==*======@                        @@.                =@#+++++#@+                                                     @@*
+=@@      @@=@@@=@    @*=====@@=%=@                     @@                 @@++++++%@:                                                           
@            @@==@=@@+**==@@    @@=+==@@             @@                 @@++++++@@.                                                              
                #@+=%=@@=          %@++%===@-@#@=+@%                .@@++++++@@                                                                  
                   .@                 .@@=+=+=@@:                -@%++++++@@                                                                     
                                          @@@.                @@*++++++@@                                                                        
                                                           @@+++++++@@                                                                           
