                @@*+++++@@.   @@++++++@=           -@                                                  .                                         
-                  .@@+++++*@++++++#@++#@            @                                                                                           
 :@#                   @@+++@++*@@  @++++@            @                                                                                          
    .@@                   +@@@.     @+++++@            @.                                                                                        
        @@                          @++++++@.           @#                                                                                       
           @@                       @+++++++@@           -@                                                                                      
           @@@                      @+++++++++@            @                                               @=*#+                                 
       .@@+++@                      @++++++++++@            @                                            @=*+@=@                                 
    +@#++++++@:                     @+++++++++++@            @.                                          +@====@                                 
 @@+++++++@@                        @++++++++++++@#           @@                                        @=%@@@*=*@                               
+++++++@@                           @+++++++++++++*@           :@                                     *=@@     :@#==@                            
+++*@+                              @+++++++++++++++@            @                                   %@           .@#@                           
@@.                                 @@+++++++++++++++@            @                               =@.                .@%                         
                                       @@+++++++++++++@-           @+                          .@=                       @@                      
                                          @@*++++++++++#@         :  =@=%=@@%@              .@@                            .@@                   
                                             -@%+++++++++@     =        @@=%=@            @@                                  .@@                
                                                .@@+++++++@ +              @@@            @++@@                                   @@             
                                                    @@+#@-                -@@@            @+++++@@                                   @@          
                                         @=@ @  @*@@@@.                @@*++**            .@@+++@@.                                     @@       
                                         @==%==*=@@                 @@++++++#=               @@.                                           @@    
                                         @=%==@@                 @@++++++*@@              @@                                                  @@ 
                                         @=@@                :@%++++++%@-              @@                  @@:                                   
                                         @@                :@*+++++@@               @@                  @@++*+*@@                                
                                         @++@@                %@@@ .%@=@@@@ @@ @@@@                  @@++++*++++++@@.                            
                                         @+++++@@                @@=+===%==*==@*                 .@@+++++@@ @@*++++++*@@                         
                                         @*+++++++@@                @@====*@=                 *@*++++*@@       .@@+++++++@@                      
                                           -@%+++++++@@                @@.                 @@+++++*@+              @@+++++++%@#                  
                                               @@+++++++@@                              @@+++++%@:                    -@@+++++++@@               
                                                  @@++++++*@*                       .@@+++++@@.                           @@+++++++@@-           
                                                     %@*+++++*@                  *@#+++++@@.                                 %@#+++++++@@        
=+%                   .@@                               -@%@@                 @@++++++@@                                        .@@+++++++@@.    
==@*              .@=++#@@                             :@#                 @@++++++@@                                               @@*++++++*@@ 
@@==@=            @===#@=#=@                        @@:                .@@++++++@@                                                     :@@+++++++
   @@=@@@==:   @=*==*=#@=#==-                    @@                 =@#+++++*@#                                                            @@++++
      +@*=#=@@@+@==@@.   @@%=*=*@             @@                 @@++++++#@-                                                                  +@%
         .@@===+@@          .@@=#=+=@-@=@*=@@                 @@++++++@@.                                                                        
             @.                 @@==*==+@@                .@@++++++@@                                                                            
                                   %@@-                -@%++++++@@                                                                               
                                                    @@*++++++@@                                                                                  
                                                 @@+++++++@@                                                                                     
                                              @@++++++*@%                                                                                        
                                               @@++*@+                                                                                           
                                                  @@                                                                                             
                                                     @@                                                                                          
