                                     @*@==@=                       @@                        -@*                                                 
                                    .+#=#++=.                      @. @@                        .@@                                              
                                   ++==@#@==%@                     @.    @@                         @@                     @@##@                 
                                  %+==@@.@@=#=@                    =@.      @@                         @@                @##@####@               
                                 @=@@.      @@@                       =@-      @@                         @@.          @####@#####@              
                                @@.            @@                        -@+     .@%                         *@-      @#####@#####%              
                             @@                   @@.                       :@*    -@-                          :@%   ######@#####%              
                          @@                         @@. - +:   @@= @          .@@.                                .@@######@#####%              
                       @@                               *@+#=%===*=@=@@=#% @ @@                                      #######@######  %=%#        
                    @@                                     -@#=#*+=@@%=@=+@#                                         #######@######@@++=%+       
                 @@                                           .@@+=@==@@.                        @@@@                #######%######=%@@@==@      
              @@                                                  @@@                         @@+++*++@@             #######%#####%@     +@*     
           @@                                                                             .@@++++++++++++%@:         ##########@-            @@  
         -@+                                                                           -@%++++++@@ @@*++++++*@#      #######@                   @
          @++@@                                                                     @@*++++++@@       .@@+++++++@@   ###%@                       
          @+++++@@                                                               @@+++++++@@              @@+++++++@@@-                          
          @*+++++++@@.                                                            @@+++@@                    @@++#@*                             
            :@@+++++++#@+                                                            #@.                        @@:                              
                @@+++++++*@@                                                            =@-       #@            @++#@=                           
 @@                #@#+++++++@@                                                            :@#==#==@            @+++++*@%                        
    #@:               .@@+++++++@@.                                                           .@@==@             @@+++++++@@                     
       -@=                @@*++++++#@=                                                           .@@                @@*++++++@@                  
          .@@                :@@+++++++@@                                                      .@@+@                   *@*++++++@@               
              @@                 @@+++++++@@                                                *@#++++@                      =@#++++++@@            
                 @@                 %@#++++++@@.                                         @@+++++++@@                         :@%++++++@@.        
                    @@                 .@@++++++#@+                                   @@++++++@@:                               .@@++++++@@.     
                       @@.                 @@*++++++@@                            +    @++*@@                                       @@++++++#@-  
                          @@.                 :@@++++++@@                     .:        @.                                             @@++++++*+
                             +@-                  @@++++++@@.              @@            @-                                               @@+++*+
                                :@#                  %@*+++++#@=        @@+++@.           *@                                                 @@*+
                                   .@@                  .@@+++++*@@  %@+++++++@@           .@                                                    
                                       @@                   @@*+++++@++++++@@+++@            @                                                   
                                          @@                   -@%++@++@@-  @++++@            @                                                  
                                             @@                    @@@      @+++++@            @=                                                
                                                @@.                         @++++++@*           +@                                               
                                                   +@-                      @+++++++*@           .@                                              
                                                  %@*@                      @+++++++++@            @                                             
                                               @@++++@                      @++++++++++@            @                                            
                                            @@++++++*@.                     @+++++++++++@-           @+                                          
                                        .@@++++++#@=                        @++++++++++++#@           -@                                       :=
                                     =@#++++++@@.                           @++++++++++++++@           .@                                     @=@
@@%+:.                            %@*++++++@@                               @+++++++++++++++@            @                                   @@  
++++++++++++++++*#%@@@@@@@@@@@@@@+++++++@@                                  +@*++++++++++++++@.           @                               @@     
+++++++++++++++++++++++++++++++@++++*@@                                        :@%++++++++++++@@           @@      *-                  @@        
