                                                                          @######@#####%==*=+                                                    
                                                                          %######@####@+@@@+==@                                                  
                                                                          %######%#@      .@@@@=@                                                
                                               -                          #####@%             @@                                                 
                                             +=#=@                        ##@.                   @@                                              
                                           .@==+%@.                       @@                        %@.                                          
                                           @===*+=@                       @  @@                        -@+                                       
                                          @%==*=*==+@                     @     @@                        .@@                    @%###@          
                                        ==#==@@:@@=@=.                    @@      .@@                         @@               @########@        
                                       @==@@      .@@*                       @@.     .@+                         @@           @##########%       
                                      .@@             @@                        @@.     :@-                         @@.      @###########@       
                                   .@#                   @@                        #@.    @@                           *@:  @######%#####@       
                                .@*                         @@  - @-  :+@:.@          *@@                                 :@#######@#####@       
                             :@*                               @@=@=@==+====@@=+ *@@@.                                     @#######@#####@  @%@. 
                          :@+                                     #@==%=#==*=++@@@                                         @#######@#####@@+#@=@ 
                       -@=                                           =@*===@=@@                        :@@@@               @#######@#####@==@@@==
                    -@-                                                 .@@.                        %@*++@+++@@            @#######@#####@=     @
 @               =@-                                                                             @@++++++@++++++@@.        @#######@#%@          
=#              @@.                                                                           @@++++++%@. @@+++++++%@-     @######@*             
=*              =#+#@#                                                                    .@@++++++@@.       *@#++++++*@@  @###@.                
=+               @+++++@@                                                              :@%++++++@@.             .@@+++++++@@@                    
%=               @++++++++@@                                                             @@++@@.                    @@++@@                       
@@@@               *@%+++++++@@.                                                            @@                        .@@.                       
     @@                @@+++++++#@*                                                            @@.    -  @.           *#++@@.                    
        @@                @@*+++++++@@                                                            @@==*===.           @*+++++#@-                 
           @@                :@@+++++++@@                                                            +@+==.             @@++++++*@*              
              @@.                @@+++++++@@.                                                           -@.                @@++++++*@@           
                 +@-                %@#++++++*@#                                                      @@+**                   @@+++++++@@        
                    :@*                 @@+++++++@@                                                @@++++*%                      %@*++++++@@     
                       .@@                 @@*++++++@@                                         :@@++++++@@.                         #@*++++++@@  
                          .@@                 :@@++++++@@.                                  .@*+++++*@@                                =@#++++++@
                              @@                  @@++++++#@*                           .-   -@++@@.                                      :@#++++
                                 @@                  @@#++++++@@                     @         @                                             .@%+
                                    @@.                  @@++++++@@              .@@            @                                                
                                       *@:                  @@*+++++@@.       .@@+++@            @.                                              
                                          -@+                  -@@+++++#@* .@@+++++++@.           @*                                             
                                             .@@                   @@+++++*++++++@@+++@*           :@                                            
                                                 @@                   @@#+*++*@@  @*+++*@            @                                           
                                                    @@                   .@@.     @*+++++@            @                                          
                                                       @@                         @*++++++@            @.                                        
                                                          @@.                     %*+++++++@-           @#                                       
                                                        .@@+@                     ##++++++++#@           .@                                      
                                                     :@%++++@                     *#++++++++++@            @                                     
                                                  #@*++++++@@                     +#+++++++++++@            @                                    
