                                .@===+*===@                      @    *@.                        @@.                    @@##@*                   
                               @=+=#@=@@==+@                     @@      @@.                        +@-               @##@#####.                 
                              @=+@=      @@@                        @@      @@                         :@#          .####%######                 
                             =@-            #@:                        @@      @@                          @@      .#####%######-                
                          =@-                  -@=                        @@    .@@                           @@   @############-                
                       +@:                        .@% . .*.  @@@ ==          @@=                                 @@#############-                
                    #@.                              .@@=+=+@=@===%@#=@ @%@@                                      @#############- :@=@           
                 *@.                                     @@=%+=%==+=#==@@                                         @##############@*#==@          
              %@.                                           @@=====#@=                        *@@@:               @#############*=#@@#=@         
           @@.                                                 @@@.                        @@+++@++*@#            @#############@.     @@       @
        @@.                                                                             @@++++++@++++++@@         @#######%#@@            @@.  @ 
       @@                                                                            @@++++++@@ .@@+++++++@@      @######@-                  -#  
       @++@@                                                                     :@%++++++@@        @@+++++++@@.  @###@                          
       @+++++@@:                                                              #@*++++++@@              @@*++++++@@@@                             
       *@+++++++*@%                                                            .@@++@@                    :@@++@@                                
          @@++++++++@@                                                            .@@                        @@@                                 
             %@#+++++++@@                                                             @@        @            @+++@@                              
#               .@@+++++++@@:                                                            @@%=#==@            @++++++@@                           
 .@@                @@*++++++*@%                                                            @@%=@             :@%++++++@@                        
     @@                :@@+++++++@@                                                            @@                .@@++++++@@                     
        @@                 @@+++++++@@                                                       @@+@                   .@@++++++%@.                 
           @@                 @@#++++++@@:                                               .@@++++@                       @@++++++#@-              
              @@.                .@@++++++*@%                                         #@*++++++@@                          @@++++++*@*           
                 *@:                 @@*++++++@@                                   @@++++++#@#                                @@++++++*@@        
                    -@+                 -@%++++++@@                            :.   @*++@@                                       @@+++++++@@  *@*
                       .@@                  @@++++++@@:                     #        @@                                             @@+++++++#+++
                           @@                  @@*+++++*@%              -@=           :@                                               @@*+++#+++
                              @@                  .@@++++++@@        -@#++#@            @                                                 #@*#@@ 
                                 @@                   @@++++++@@  :@#+++++++@            @                                                       
                                    @@                   =@%+++++@++++++@@+++@            @.                                                     
                                       %@.                   @@++@++%@@  @++++@.           @@                                                    
                                          =@=                   @@@      @+++++%@           .@                                                   
                                             .@%                         @+++++++@            @                                                  
                                                 @@                      @++++++++@            @                                                 
                                               :@%%-                     @+++++++++@            @.                                              #
                                            *@*+++*@                     @++++++++++@#           %@                                           @=@
                                         @@+++++++@@                     @+++++++++++*@           .@                                          @==
                                      @@++++++*@@                        @+++++++++++++@            @                                        @==@
                                  .@@++++++#@+                           @++++++++++++++@            @                                      =@@  
%+..                           -@%++++++@@.                              @+++++++++++++++@-           @:                                  @@     
++++++++++++++*#%@@@@@@@@@@@@@*++++++@@                                   @@++++++++++++++#@           #@                              @@        
++++++++++++++++++++++++++++++++++@@                                         @@+++++++++++++@           .@.     .#.                 *@.          
+%@@@@@@@@@@@@**++++++++++++++*@@                                               @@+++++++++++@        ..   @@===+=@              :@-             
                        .:*@@=                                                     @@*++++++++@.    .         @@=+@            .@%               
