                                                                             #######@#####@=@@                                                   
                                                                            .#######@#####@@==%@                                                 
                                                                            .#######@#####@=*==@                                                 
                                                                            .#######@####@@@=%==+@                                               
                                                                            .#######@#@      *@+++=.                                             
                                                                            :#####@*            :@@                                              
                                               :====@                       -##@.                  .@@                                           
                                              *#===#@                       .@+                        @@                                        
                                              @==+@==@                       @ :@-                        @@                                     
                                            .@===*+===@.                     @    +@.                        @@.                    @@##@#       
                                           @=*=*@*@@+=+@                     @@      #@.                        =@=               @##@#####-     
                                          @==@*      @@#                        @@      @@                         .@@          .####%######     
                                         :@+            +@-                        @@      @@                          @@       ############*    
                                      :@=                  :@*                        @@     @@                           @@   @############*    
                                   =@-                        .@@ .  +.  @@@ -#          @@*                                 @@##############    
                                =@:                               @@=*=+%=@===*@@=@ #@@@.                                     @############## .@=
                             +@:                                     @@=*+=%==+=*==@@                                         @#############%@+*=
                          *@.                                           @@=====*@#                        =@@@-               @#############%=*@@
                       %@.                                                 @@@.                        @@*++@++*@@            @#######%#####@.   
    @               #@.                                                                             @@++++++@++++++@@         @#######@#%@       
  @=@              @@                                                                            @@++++++@@..@@+++++++@@      @######@+          
  @=@              @++@@                                                                     .@@++++++@@.       @@+++++++@@.  @###@              
=@=#@              @*++++%@:                                                              +@#++++++@@              @@*++++++%@@@                 
=@=+@              =@+++++++*@%                                                            .@@++@@                    :@@++@@                    
*==@@@.               @@++++++++@@                                                             @@                        @@@                     
@%     -@=               *@#+++++++@@                                                             @@        @            @+++@@                  
          .@%               .@@+++++++%@:                                                            @@*=%==#            @++++++@@               
              @@                @@*++++++*@@                                                            @@@=*             .@%++++++@@            
                 @@                :@@+++++++@@                                                            @@                .@@++++++@@.        
                    @@                 @@+++++++@@.                                                      @@+@                   .@@++++++%@:     
                       @@                 #@#++++++%@:                                               .@@++++@                       @@++++++#@=  
                          @@.                .@@++++++*@@                                         +@#++++++@@                          @@++++++*@
                             +@-                 @@*++++++@@                                   @@++++++#@@                                @@+++++
                                :@*                 :@@++++++@@                            ..   @*++@@.                                      @@++
                                   .@@                  @@++++++@@:                     %        @@                                             @
                                       @@                  #@*+++++*@@              :@*           .@                                             
                                          @@                  .@@++++++@@        :@#++*@            @                                            
                                             @@                   @@*+++++@@. .@%+++++++@            @                                           
                                                @@.                  -@@+++++@++++++@@+++@            @:                                         
                                                   *@:                   @@++@++#@@  @++++@-           *@                                        
                                                      -@*                   %@@      @+++++#@           .@                                       
                                                         .@@                         @+++++++@            @                                      
                                                            .@@                      @++++++++@            @                                     
                                                           .@@*+                     @+++++++++@.           @-                                   
