                                                                             =#############*=                                                    
                                                                             %#############%%@@                                                  
                                                                             @#######%#####@=+*=@                                                
                                                                             @#######%#####@@==*@                                                
                                                                             @#######@##@%  *@+===@                                              
                                                                             @#######@.        :@%=@                                             
                                                 @@@.                        @###%@               .@@                                            
                                                @====                        @@.                      @@                                         
                                               @=+@@==.                      %-@*                        @@                                      
                                              @**%===@-                      @:  .@=                        @@.                        .         
                                            ====+=@====@                     @.     =@:                        +@-                  @#@###@.     
                                            %#=@@   @@==@                      @@      #@.                        .@%             @###@#####@    
                                          #=@@         +@-                        @@      @@.                         @@         @####@######    
                                         @@               :@*                        @@      @@                          @@     @#####@######    
                                      @@                     .@@                        @@  @@                              @@.=######@######    
                                   @@                            @@@@#=#@@=#=@=#        .@@                                    @######@######   .
                                @@                                  @@=#=#==*%@=++=@%#@=                                       %######%######  +*
                             @@                                        @@==%=%=#*=@@                         :                 %######%######@#==
                          @@                                              @@=#=@@                        .@@+%*@#              ##############=@@ 
                       @@                                                    :                        -@%++++*++++@@           ############@.    
    +@             .@@                                                                             %@*+++++*@@+++++++@@        #########@        
   *%@              @@@                                                                         @@++++++*@*    @@+++++++@@.    #####@#           
=@@+=@              @+++@@:                                                                  @@++++++*@*          @@*++++++%@: ##@.              
#@===@              @++++++*@%                                                             @@+++++*@+                -@%+++++@@:                 
*==+=@               @@++++++++@@                                                             @@@=                       @@@                     
==@@  =@=               @@*+++++++@@                                                             @@                       @+@@                   
@        .@@               .@@+++++++@@.                                                            @@ @@@%@@@            @++++@@                
             @@                @@+++++++*@#                                                            @@==%=@            @@++++++@@             
                @@                +@%+++++++@@                                                            @@=@              .@@++++++@@.         
                   @@                 @@+++++++@@                                                          -@@                  @@++++++%@:      
                      @@                 @@*++++++@@:                                                   @@*++@                     @@++++++*@=   
                         @@.                .@@++++++*@#                                             @@++++++@                        @@++++++*@%
                            +@-                 @@+++++++@@                                      .@@++++++@@:                            @@++++++
                               :@*                 +@#++++++@@                                = @#++++*@@                                   @@+++
                                  .@@                  @@++++++@@.                        .-     +@@@.                                         @@
                                      @@                  @@*+++++*@%                              @                                             
                                         @@                  :@@++++++@@            @@+@            @                                            
                                            @@.                  @@++++++@@      @@+++++@            @.                                          
                                               @@.                  *@#+++++@@@@+++++++++@            @+                                         
                                                  *@-                  .@@++++@++++@@+@+++@*           =@                                        
                                                     :@*                   @@*@*@@    @++++*@            @                                       
                                                        .@@                           @++++++@            @                                      
                                                            @@                        @+++++++@            @.                                    
                                                              @@                      @++++++++@:           @#                                   
