            @@++++++@@.                @            @                                               @@++++#+++++@@                               
               @@*+++++%@-          @@++@            @                                                 @@+#+*@@                                  
                  :@@+++++*@%    @@++++++@            @:                                                  @-                                     
 @@                   @@++++++@@+++++++*++@:           #@                                                                                        
    @@                   *@#+++@+++@@= @+++%@           .@                                                                                       
       @@                   .@@%@@     @+++++@            @                                                                                      
          @@.                          @++++++@            @                                                                                     
             #@:                       @+++++++@.           @:                                                                                   
              @@@                      @++++++++@#           *@                                               @=@@                               
           @@+++@                      @+++++++++*@           .@                                            @=@%=@@                              
        @@++++++@.                     @+++++++++++@            @                                           =*====@                              
    .@@++++++@@:                       @++++++++++++@            @                                         @=+#@@=%=@                            
 +@#++++++@@                           @+++++++++++++@-           @-                                     -=+@-    @@##@.                         
*++++++@@                              @++++++++++++++#@           +@                                   .@%          @@=+                        
++++@@                                 @*+++++++++++++++@           .@                                @@                @@                       
*@*                                      -@%+++++++++++++@            @                            @@                      @@                    
                                            .@@+++++++++++@.         @  @@@@%@@=@               @@                            @@.                
                                                @@+++++++++@@     %       .@**=#@            %@                                  @@.             
                                                   @@+++++++*@ +             +@=*            @+%@.                                  @@           
                                                      @@+++@@                 @@=            @++++%@.                                  %@.       
                                            *=@ *  @@@ .@@                .@@++%-            @@+++++@@                                    *@.    
                                            *=*++=@=+@#                =@%+++++@.               -@@                                          +@: 
                                            %==+=#@:                @@+++++++@@              -@+                                                =
                                            @=@@.                @@+++++++@@              *@:                  @                                 
                                            @-                @@++++++*@@              @@.                 -@@+*+@@.                             
                                            @+#@.                @@@@:  @%@.@= .@ . @@                  @@*+++%+++++#@#                          
                                            @++++%@.               .@%=*==#=#=#==@@                  @@+++++@@:@@+++++++@@                       
                                            @+++++++@@.               .@#=====@@                 .@@+++++@@       @@+++++++@@=                   
                                              @@+++++++@@                :@@@                 :@%+++++@@             +@%+++++++@@                
                                                 @@+++++++@@                               #@*+++++@@                    @@+++++++@@.            
                                                    #@#++++++@@                         @@+++++*@%                          %@*++++++*@@         
                                                       .@@++++++@@                   @@+++++*@+                                .@@+++++++@@.     
 @==@                     @                                @@+@@.                .@@+++++%@:                                       @@+++++++*@#  
@====@                @+=%%=@                              @@                 %@*+++++@@.                                             -@@+++++++@
==@@==#%             @==@=##=@@                         @@                 @@++++++@@                                                     @@+++++
@    -@%=@.@#@    @=%==@==+===*                     :@@                 @@++++++@@                                                           %@#+
         @@===%@:@@+==*@*  .@@+@=@@@             *@-                .@@++++++@@                                                                  
            @@==+==@@          @@=====*@ @@@@@@@.                +@#++++++@@                                                                     
               %@@                %@+=@==@#@@                 @@++++++*@%                                                                        
                                     .@@@@                 @@++++++#@=                                                                           
                                                       .@@++++++%@.                                                                              
                                                    +@#++++++@@.                                                                                 
                                                 @@*++++++@@                                                                                     
                                                 :@#+++@@                                                                                        
