               *@#+++++#@+     :@#++++@*           .@                                                  @@@                                       
                  .@@++++++@@@%++++++++*@            @                                                                                           
 @@                   @@*+++*+++++@@@++++@            @                                                                                          
    @@                   :@@*+@@:   @+++++@            @.                                                                                        
       @@                           @++++++@:           @@                                                                                       
          @@.                       @*++++++#@           .@                                                                                      
             @@                     @*++++++++@            @                                                @@@                                  
         :@%++@                     #*+++++++++@            @                                             +@+%+=.                                
      %@*+++++@                     *#++++++++++@.           @.                                          @==@%*=+                                
   @@+++++++@@                      +#+++++++++++@%           %@                                         @=@@@=@=@                               
@@++++++*@@                         =#++++++++++++*@           .@                                      :*=@@   @@==@.                            
+++++#@-                            :#++++++++++++++@            @                                     @@         @@=@                           
++@@.                               :%+++++++++++++++@            @                                 @@               @@                          
@                                     *@*+++++++++++++@+           @:                            #@.                    @@                       
                                         :@%+++++++++++*@          . @@=-@* ++                -@:                          @@                    
                                            .@@++++++++++@      ..     .@+%=@=             .@*                                @@                 
                                                @@++++++++@   :           *@=#             @@@                                   @@              
                                                   @@++++%@.                =@            .@+++@@.                                  @@           
                                         -%*      :   @@.                @@*+@            =@++++++@@                                   @@.       
                                         :====@@=+=@@                 @@+++++@               @@@@                                         @@.    
                                         .%==%==@@                .@@++++++*@#              @@                                               @@. 
                                         .*=+@@                =@#++++++@@.              @@                                                     *
                                         .@#                @@*++++++@@               @@                  @@%+@@                                 
                                         #*@@.               .@@++@@  @=  .   .   .@%                 .@@+++@++++@@:                             
                                         =#+++@@.               .@@@==#====@=#@+@=                 :@%++++*@@#++++++*@@                          
                                         -%++++++@@                :@+=#=%==@@.                 #@*++++*@+    .@@+++++++@@.                      
                                          .@@+++++++@@                =@=@@.                 @@+++++%@-           @@*++++++*@@                   
                                              @@+++++++@@                                 @@+++++@@.                 .@@+++++++@@                
                                                 @@*++++++@@                          :@@+++++@@                         @@+++++++%@*            
                                                    =@#++++++@@                    %@*+++++@@                               +@@+++++++@@         
%@                                                     .@@++*@@                 @@++++++@@                                      @@+++++++@@-     
=#=                 *@*===*                              +@=                 @@++++++@@                                            @@*++++++*@@  
@=*==              #===*@+@-                          @@.                .@@+++++*@#                                                  .@@+++++++@
  @@+===  @.    +@+#==%=*==*@                      @@                 *@*+++++#@=                                                         @@*++++
     .@@=%#%+  @==@==@@ =@%=#@@-.               @@                 @@++++++@@.                                                               :@@+
         @@==%%==+@@        @@=*==@@#   # @+@@@                 @@++++++@@                                                                       
            @@@@.              @@==#===+=+@+                .@@++++++@@                                                                          
                                  -@%+@@.                *@#++++++@@                                                                             
                                                      @@+++++++@@                                                                                
                                                   @@++++++*@@                                                                                   
                                               .@@++++++*@*                                                                                      
                                              =@*++++#@-                                                                                         
                                                 *@@.                                                                                            
                                                    *@.                                                                                          
