                                                               @@++++++*@%           @@+++++++@@ @#@:                             -         %@+++
:                                                            =@*++++*@@                 @@*++++%@-                                   @     @+++++
+*@%                                                            -@@#                       :@@                                          .*@+++@@@
+++++@@                                                            .@#                      @**@@                                           @@+*=
%+++++++@@                                                            .@@@@@=+@=            @+++++@@                                           @@
  @@+++++++@@:                                                            @@==#=            =@*++++++@@                                          
     @@*++++++*@#                                                            @@=               -@#++++++@@                                     @@
        .@@+++++++@@                                                         :@@                  :@%++++++@@                              .@@+++
            @@+++++++@@                                                   @@*++@:                    .@@++++++@@.                       -@%++++++
               *@#++++++@@:                                            @@++++++#+                       .@@++++++%@:                 #@*+++++++@@
@.                .@@++++++*@%                                     .@@++++++@@:                             @@++++++#@=           @@+++++++*@#   
  %@.                 @@*++++++@@                               =  @++++*@@                                    @@++++++*@#     @@+++++++@@:      
     =@=                 :@@++++++@@.                       .-      @@@.                                          @@+++++++@@@+++++++@@          
        :@%                  @@++++++@@.                             @:                                              @@+++++@+++++@@             
            @@                  #@#+++++*@#           @@+@.           %@                                                @@++@+*@@                
               @@                  .@@++++++@@     @@+++++@@           .@                                                  @@:                   
                  @@                   @@*+++++@@@++++++++++@            @                                                                       
                     @@                   :@@+++#++++@@+@++++@            @                                                                      
                        @@.                   @@##@@    @+++++@            @:                                                                    
                           +@:                          @++++++@+           *@                                                                   
                              :@*                       @+++++++*@            @                                                                  
                                @@%                     @+++++++++@            @                                                @+@.             
                             @@+++@                     @++++++++++@            @                                             @==+@=.            
                         .@@++++++@                     @+++++++++++@:           @-                                          @=*=+=+.            
                      :@%++++++@@.                      @++++++++++++%@           +@                                         %=@@@=%=*           
                   #@*++++++@@                          @++++++++++++++@            @                                      @**@.   @@+#@+        
                @@+++++++@@                             @*++++++++++++++@            @                                    .@=         @@=@       
@+..         @@++++++*@@                                @%+++++++++++++++@.           @.                               .@%               @@.     
++++++++++++#+++++#@+                                     .@@+++++++++++++@#           @=                            @@                     @@.  
++++++++++++%++@@.                                            @@+++++++++++*@          @ @@@@#@.==                @@                           %@
@@@@@@@@@@@#@@                                                   @@++++++++++@      @       @@==++             @@                                
                                                                    @@++++++++@  #            .@*#             @*@=                              
                                                                       *@*+++@@                 @@            :%+++*@*                           
                                                             @@#     *@  .@@                .@@++@            *@*+++++@*                         
                                                             +====*=@=*@+                +@#+++++@               .@@%                            
                                                             ======%@:                @@+++++++@@              =@=                               
                                                             -==@@.                @@+++++++@@              #@.                 .                
                                                             @@                 @@++++++*@%              @@.                 -@%@+@@.            
                                                             @+*@#                @@+@@:  @@  @  .@   @@                  @@*+++@++++*@@         
                                                             @++++*@=                @@#*=##==@=#=@@@                  @@+++++@@@@+++++++@@      
                                                             #*++++++*@:                @@=@#===@@                 .@@+++++@@      @@*++++++#@%  
                                                               @@+++++++#@.                @@@@                 :@%+++++@@            :@@+++++++@
                                                                  @@*++++++@@.                               %@*+++++@@                   @@+++++
                                                                     :@@++++++@@.                         @@+++++*@%                         *@%+
