  @@#++++++@@:                                               @@*++++@                       @@++++++#@-                    -@#+++++++@@          
     .@@++++++*@%                                         @@++++++*@@                          @@++++++*@*              %@*+++++++@@             
         @@*++++++@@                                   @@++++++@@                                 @@++++++*@@        @@+++++++#@+                
            -@%++++++@@                            @    @++#@@                                       @@+++++++@@  @@+++++++@@.                   
                @@++++++@@:                    :.        @:                                             @@++++++++++++++@@                       
@                  @@*+++++*@%              @@.           *@                                               @@*+++++++@@                          
  @@                  .@@++++++@@        @@+++@@           .@                                                 #@**@%                             
     @@                   @@++++++@@  @@+++++++*@            @                                                                                   
        @@.                  =@%+++++@+++++*@@+++@            @                                                                                  
           %@.                   @@++@++@@.  @++++@            @-                                                                                
              =@=                   @@+      @+++++@+           +@                                                                               
                 .@#                         @++++++*@            @                                                                              
                    .@@                      @++++++++@            @                                                  .                          
                   @@+@                      @+++++++++@            @                                               @===@                        
                @@++++@:                     @++++++++++@:           @=                                           @+===%%                        
            .@@++++++#@.                     @+++++++++++%@           =@                                          @===@==@                       
         :@%++++++@@.                        @+++++++++++++@            @                                       :=@*@:@@==@-                     
      %@*++++++@@                            @++++++++++++++@            @                                     @=@=      @@==#:                  
   @@+++++++@@                               @+++++++++++++++@.           @                                  .@%            #@%                  
@@++++++*@@                                  .@@++++++++++++++@@           @+                              @@                  +@:               
#++++#@+                                         @@++++++++++++*@           -@.     %@:                 @@                        =@-            
#+@@.                                               @@+++++++++++@        @    @@=====@              @@                              -@=         
@                                                      @@*++++++++@    *          @@==@            @@%                                  :@+      
                                                          =@#++++++@.               .@@            @+++@@                                  .@#   
                                                   @-        .@@@@                 @@+@            @++++++@@                                  .@@
                                                  @*@@@ +*+@@@@                .@@++++@             -@@++@@                                      
                                                  @=%==%=+@+                *@#++++++@@              .@%                                         
                                                  @+==%@:                @@+++++++@@              -@=                                            
                                                  @@@.                @@+++++++@@              #@.                 .@@@.                         
                                                  @@@                @@++++#@*              @@.                 =@#++*++#@@                      
                                                  @+++@@                @@* @@@==@=@@@=-@@@                  @@*++++%+++++++@@                   
                                                  @++++++@#                @@*+==*=@==@@                  @@+++++@@.  @@+++++++%@+               
                                                  @@+++++++*@+                @@=+=@@                 .@@+++++@@         =@@+++++++@@            
                                                     @@*++++++*@-                @                 -@%+++++@@                @@+++++++@@:        
                                                        :@@++++++#@.                            @@*+++++@@                      @@#++++++*@@     
                                                            @@++++++%@.                      @@+++++*@%                             @@+++++++@@. 
         #                                                     @@+++++@@                 .@@+++++#@=                                   @@*++++++*
       @=+=@                  .@=@@                               %@@                 -@%+++++@@:                                         :@@++++
     @===*==@=             +=++=*=@                             @@                 @@*+++++@@.                                                @@+
   :@==@@.@@==@+  .       .%=*=@@==++                       .@@                 @@++++++@@                                                       
 @==@@       @@=%*==@   @*==%==@@@=@=@                   -@*                 @@++++++@@                                                          
%@@             @@=%#=+=%%=@@-     @@====*#           #@:                :@%++++++@@                                                             
                   -@%==@@            =@%=@+==@+=%=@@.                %@*++++++@@                                                                
                                         .@@==%=@@                 @@++++++*@*                                                                   
