                   #@.                     @@                        @@  -@@                             @@. %############@                     =
                %@.                           @@:@==#@.@==@%@         @@.                                   @#############@   .                @.
             %@.                                 @@@*=*==+#%==@==@=@@                                       @#############@ @==*              @  
          %@.                                       @@+=*====%=+@@                        .                 @#######%#####@====*@.          @@   
       @@                                              *@===@@.                        @@*@+@@              @#######%#####@@@. @@@         @     
    @@.                                                   :                         @@++++@++++@@           @#######@###%@        @@.    .@      
 @@.                                                                            .@@++++++@@+++++++@@.       @#######@@=              :@@@*       
 @@@.                                                                        .@@++++++@@    @@+++++++@@:    @#####@                      -       
 @+++#@+                                                                  +@#++++++@@          #@#++++++*@* @#%@                            @ .  
 +#++++++@@                                                             @@++++++@@                .@@++++++@@                                  :.
  @@++++++++@@                                                             @@@@                       @@@#                                       
     *@%+++++++@@.                                                            @@                       @+@@                                      
         @@+++++++#@=                                                            @@ @@.%@@=            @++++@@.                                  
            @@*++++++*@@                                                            @@==+==            @@++++++@@.                               
               :@@+++++++@@                                                            %@=+               @@++++++#@-                            
@@.                @@+++++++@@.                                                          @@                  @@++++++*@*                         
   @@.                #@#++++++#@+                                                   .@@++@.                    @@++++++*@@                      
      =@=                .@@+++++++@@                                             =@%+++++@.                       @@+++++++@@                  .
         :@%                 @@*++++++@@                                       @@*+++++*@@                            @@*++++++@@            .@%+
            .@@                 :@@++++++@@.                                *:@+++++@@.                                  %@*++++++@@      +@*++++
                @@                  @@++++++#@+                         %      @*@@                                         +@*++++++@@@@+++++++*
                   @@                  #@#++++++@@                  ..          @                                              -@#+++++@+++++@@. 
                      @@                  .@@++++++@@            +@*@            @.                                               .@%++@++@@     
                         %@.                  @@*+++++@@.     =@*++++@.           @#                                                  @@@        
                            +@-                  -@@+++++#@+@*++++++++@*           .@                                                            
                               :@#                   @@++++@+++++@@@+++*@            @                                                           
                                  .@@                   %@*@+@@.   @+++++@            @                                                          
                                      @@                   .       @++++++@            @.                                                        
                                         @@                        @+++++++@-           @%                                                       
                                           .@+                     @++++++++#@           .@                                                @@#   
                                        +@#++@                     @++++++++++@            @                                             #@=#==  
                                     @@++++++@                     @+++++++++++@            @                                           @==#=@=. 
                                  @@+++++++@@                      @++++++++++++@.           @:                                         @=*%*=*=@
                               @@++++++*@#                         @+++++++++++++@@           @@                                      %#=@@  .@#=
                           :@%++++++@@:                            @++++++++++++++*@           .@                                    .@@        .
@@@@@@#=-.              *@*++++++@@                                @*+++++++++++++++@            @                                 @@            
+++++++++++++++++++**#%*++++++@@                                     @@++++++++++++++@.           @                             @@.              
+++++++++++++++++++++++*++*@@                                           %@*+++++++++++@+          :.@--.@..=#                +@.                 
   :=@@@@@@@@@@@@%#*+++%@*                                                 -@#+++++++++*@      ..     %@=%=#%             :@-                    
                                                                              .@@++++++++@  ..           @@=@            .@@@                    
                                                                                  @@++++@@.                *@            =#+++@@                 
                                                                        @@@      :   @@                 @@++@            @@++++++@#              
                                                                        @====@@===@@                 @@+++++@               @@@@                 
                                                                        @#==@==@@                .@@++++++#@-              @@                    
