                                                                         :@%++++++@+++++++@@        @#######@#@.             @@. @               
                                                                      *@*++++++@@  .@@+++++++@@     @######@                    -                
                                                                   @@+++++++@@         @@+++++++@@. @##@#                           -           @
%@:                                                             @@+++++++@@               %@*++++++%@.                                 @      :@+
+++*@%                                                            .@%+@@                     :@@@@:                                       :. @*++
+++++++@@                                                            .@@                       :%@@                                           @@@
+@#+++++++@@                                                             @@ +- @@.%-           #*+++@@                                           
   .@@+++++++@@:                                                            @@==%==.           @#++++++@@                                        
       @@*++++++*@@                                                            @@==.             :@%++++++@@                                     
          :@@+++++++@@                                                            @.                .@@++++++@@                                 @
              @@+++++++@@                                                     =@%+**                   .@@++++++@@.                         .@@++
                 *@#++++++%@:                                              @@*++++*@                       @@++++++#@-                   -@%+++++
 @@.                .@@++++++*@%                                        @@++++++#@@                           @@++++++*@*             #@*+++++++@
    *@:                 @@*++++++@@                                 ..@++++++@@.                                 @@++++++*@%       @@+++++++#@*  
       -@+                 :@@++++++@@                           @     @+#@*                                        @@+++++++@@ @@+++++++@@.     
          .@@                  @@++++++@@-                   -.         @                                              @@++++++@++++++@@         
             .@@                  %@#+++++*@@             @@@            @.                                               @@*++@+++@@            
                 @@                  .@@++++++@@       @@++++@.           @#                                                 *@@@#               
                    @@                   @@++++++@@ @@++++++++@*           :@                                                                    
                       @@.                  -@@++++*+++++*@@+++*@            @                                                                   
                          #@:                   @@+*++@@.  @*++++@            @                                                                  
                             -@+                   @-      @*+++++@            @.                                                                
                                .@@                        @*++++++@-           @@                                                               
                                    @@                     %*+++++++#@           .@                                                 @.           
                                 @@++@                     ##+++++++++@            @                                              @*@==.         
                              @@+++++@                     *#++++++++++@            @                                           -%=%%+=#         
                          .@@++++++#@+                     =#+++++++++++@.           @.                                         @=%=@%#@@        
                       :@%++++++@@.                        -%++++++++++++@@           %@                                       @@+@: @@==@+      
                    %@*++++++@@                            :%+++++++++++++*@           .@                                     *@*       %@==@    
                 @@+++++++@@                               :%+++++++++++++++@            @                                  @@             #@@   
+++++++*#%@@@@@@++++++*@@                                   .@@++++++++++++++@            @                              @@                   +@:
+++++++++++++++@+++#@=                                          @@++++++++++++@+           #@   @  @@.                @@                         
@@@@@%#++++++++@@@.                                                @@++++++++++*@       #     @@=====.             @@                            
                                                                      %@*++++++++@   +           @@==             @@@                            
                                                                         -@#+++++@@                .@             @+++@@                         
                                                                .@@         .@@@                 @@+@            :@++++++@%                      
                                                                :@=@@@@@*=#@@                .@@++++@              :@@+@@                        
                                                                .=#==%=*@+                *@*++++++@@              .@@                           
                                                                .+=#%@:                @@+++++++@@              -@+                              
                                                                .@@.                @@+++++++@@              #@:                 .@@@@.          
                                                                ##@@                @@+++#@*              @@.                 +@#++@+++*@@       
                                                                =#+++@@                @@@++*=====@%=@@@@.                 @@*++++@@+++++++@@.   
                                                                :%+++++*@*                @@==+==%=*@@                  @@+++++@@    @@*++++++#@*
                                                                 @@+++++++*@+                @@==@@                  @@+++++@@          :@@++++++
