              @@++++++@@          .@@+@@            @                                                .@@+@+@@.                                   
                 #@*+++++%@:   .@%++++++@            @                                                   @                                       
@+                  .@@+++++*@@++++++#+++@            @                                                                                          
  .@@                   @@+++*++++@@ @++++@.           @=                                                                                        
      @@                   =@@@@.    @+++++@+           =@                                                                                       
         @@                          @++++++*@            @                                                                                      
            @@                       @*+++++++@            @                                                                                     
             @@@                     @*++++++++@            @                                                %**@                                
         :@@+++@                     %*+++++++++@:           @+                                            @==%=#*                               
      %@*++++++@                     #*++++++++++%@           -@                                          @=%=#=#+                               
   @@+++++++@@                       #*++++++++++++@            @                                        :==@@@#=#=                              
@@+++++++@@                          **+++++++++++++@            @                                      @=@@    .@@+=@                           
+++++#@+                             +*++++++++++++++@.           @.                                   @@           @@@                          
++@@.                                -@+++++++++++++++@@           @+                               *@.                @@                        
@                                       @@*++++++++++++*@           -@                           -@:                      @@                     
                                           +@*+++++++++++@         .. .@@@*@@@=               .@*                            @@                  
                                              .@%+++++++++@      :       %@=@=%             @@                                  @@               
                                                 .@@+++++++@= =             @@*             @+@@                                   @@            
                                                     @@++#@-                -@@            :@++++@@                                   @@         
                                          +*=  : -@@  @@.                %@*++@            .@@++++@@.                                    @@      
                                          :===@==+=@@.                @@++++++@                @@.                                          @@   
                                          :==%==@@                 @@++++++*@%              @@                                                 @@
                                          .==@@                -@%++++++%@:              @@                  %-                                  
                                          @@                 @#++++++@@               @@                  @@+@++@@                               
                                          %*+@@                -@*@@ : @@*+@  #@...@@                  @@++++@+++++@@.                           
                                          **++++@@                *@=+=%=+%==*=%@*                 .@@+++++@@@@*++++++*@@                        
                                          =%+++++++@@                %@=@+==*@-                 #@*++++*@#      .@@+++++++@@.                    
                                            .@@+++++++@@                @@@.                 @@+++++#@=             @@*++++++#@#                 
                                                @@+++++++@@                               @@+++++@@.                   -@@+++++++@@              
                                                   @@+++++++@@                        .@@+++++@@.                          @@+++++++%@=          
                                                      %@*++++++@*                  *@*+++++@@                                 #@#+++++++@@       
+==@                    .@                               :@@*@@                 @@++++++@@                                       .@@+++++++@@:   
%*=%+               -@==*%==                             -@+                 @@++++++@@                                              @@*++++++*@@
@@@==#-            .+=++==%=@.                        %@.                .@@++++++@@                                                    .@@++++++
    @@==-:@=@    @=+==#+*=#@=@                     @@                 +@#+++++*@*                                                           @@+++
       -@#=*=@@@#=@==@@   *@*=*+@@.             @@                 @@++++++#@-                                                                 =@
          .@@==+==@@         .@@=@===@*.@@@*@@@                 @@++++++@@.                                                                      
              @@.                @@==*+===@*                .@@++++++@@                                                                          
                                    *@%@:                =@#++++++@@                                                                             
                                                      @@+++++++@@                                                                                
                                                   @@+++++++@@                                                                                   
                                               .@@++++++*@@                                                                                      
                                                @@+++#@+                                                                                         
                                                   @@                                                                                            
