    @@                                           @@=@=*#=@@:                        %@@-               :#######@#####@==%@@==@         @         
 @@                                                 @@@@                         @@++*++*@@            -#######@#####@@     @@        @          
                                                                              @@+++++@++++++@@         =#######@##@+           @@.  @@           
                                                                          .@@++++++@@.@@+++++++@@      +#######@.                 :@             
@                                                                      +@#++++++@@       @@+++++++@@.  *####@                         -          
++%@-                                                               @@*++++++@@             @@*++++++%@#@*                               @       
+++++*@@                                                            .@@+++@@                   :@@++*@%                                     :.  .
@++++++++@@                                                             @@                         @@                                           @
  *@#+++++++@@                                                             @@        @             @++@@                                         
     .@@+++++++%@:                                                            @@==%*=*@           :@+++++@@                                      
         @@*++++++*@@                                                            @@===*            .@@++++++@@                                   
            :@@+++++++@@                                                            @@-               .@@++++++@@.                               
                @@+++++++@@.                                                      .@@+@                   @@++++++%@:                            
@@                 #@#++++++%@-                                                -@%++++@                      @@++++++*@=                      @@+
   @@.                .@@++++++*@%                                          @@*++++++@@                         @@++++++*@%               .@@++++
      =@-                 @@*++++++@@                                    @@++++++@@+                               @@+++++++@@         +@#+++++++
         :@#                 :@@++++++@@                             -.  +@+++@@                                      @@+++++++@@   @@*++++++#@# 
            .@@                  @@++++++@@-                     .+       .@-                                            @@+++++++@+++++++@@.    
                @@                  #@*+++++*@@               @@            @                                               *@*+++@++++@@        
                   @@                  .@@++++++@@         #@*++@            @                                                 =@*@+@@           
                      @@                   @@++++++@@.  %@*++++++@            @=                                                  .              
                         @@.                  -@%+++++%*++++++@#++@=           =@                                                                
                            *@-                   @@+++*++%@% -%+++#@           .@                                                               
                               :@#                   %@@@     :@+++++@            @                                                              
                                  .@@                         .@++++++@            @                                                             
                                      @@                      .@+++++++@.           @+                                                           
                                     =@#@                     .@++++++++@@           -@                                               @#*%       
                                  @@*+++@                     .@++++++++++@           .@                                            @=@#@=@      
                               @@+++++++@                     .@+++++++++++@            @                                          :=*=*==@      
                            @@++++++*@*                       .@++++++++++++@.           @                                        +===@@@==++    
                        :@@++++++%@:                          .@+++++++++++++@*           @#                                     @=@@     *@=%+@ 
                     %@*++++++@@.                              @++++++++++++++*@           :@                                   @@           =@+@
*#@@@@@@@@@@@@@@@=@@+++++++@@                                  @@+++++++++++++++@            @                               @@                 -
++++++++++++++++++@+++++@@                                        @@+++++++++++++@            @.      .                   @@                     
#*++++++++++++++++@+*@*                                              @@+++++++++++@-        -   @@=+=@*@-              %@                        
          .:+@@@@@@:                                                    #@*++++++++#@    :         @@=+=.            @@                          
                                                                           -@%+++++++@..              @%.            @++@@                       
                                                                              .@@+@@                 @@@             @+++++@@                    
                                                                    ==@:@ -@=--@@                 @@+++@             -@@+++@@                    
                                                                    ==%@=#*=@@                .@@++++++@                @@                       
                                                                    ==@==@#                +@#++++++@@.             .@@                          
                                                                    =*@-                @@+++++++@@              .@@                  @@         
                                                                   .@@                @@++++++@@              =@=                 .@@+#++#@@     
                                                                   .@++@@                @@@* @@@=@@@-:@@:@#@:                 -@#++++@++++++@@  
