                                           %                          #####@.             @@                                                     
                                         ====@                        #%@                    @@.                                                 
                                       -====+@-                       @@                        =@=                                              
                                       @==@=#=@                       @  @@                        .@@                                           
                                     #@%=#==%===#                     @     @@                         @@                    @####@              
                                    @*==%@..@@=*=                     %@.      @@                         @@               @########@            
                                   @=%@.       @@=                       #@.      @@                         @@.         .###########:           
                                  @@.             @@                        +@:     .@*                         #@:      ############@           
                               @@.                   @@                        -@=   =@*                           -@+  @############@           
                            @@.                         @@..# @@  @=@#@@          @@.                                 .@#############@           
                         @@.                               *@=#=%*==#==*@=%*.@@@@                                      @#############@ =#=@      
                      @@                                      -@*=*=+=*==@=%@#                                         @#######@#####@@+#@+@     
                   @@                                            .@%===+@@.                        @@@@@               @#######@#####@=@@@@=+    
                @@                                                   @@                         @@+++@+++@@            @#######@####%@      +@=  
             @@                                                                             .@@++++++@++++++@@:        @#######@#@:            .@
            @@=                                                                          :@%++++++@@  @@*++++++*@#     @######@.                 
            @*+*@@                                                                    %@*++++++@@        :@@+++++++@@  @##%@                     
            =#+++++@@                                                              @@+++++++@@               @@+++++++@@-                        
             @*+++++++@@.                                                            @@++@@                     @@+#@*                           
               :@@+++++++#@=                                                            @@.                       @@@.                           
 @@                @@+++++++*@@                                                            #@: =  %. @            @+++#@-                        
    @@                *@#+++++++@@                                                            =@*=====            @++++++*@*                     
       @@.               .@@+++++++@@.                                                           :@#==              @@++++++*@@                  
          *@-                @@*++++++%@=                                                           .@                 @@+++++++@@               
             :@*                -@@++++++*@@                                                     .@@+@.                   #@*++++++@@            
                .@@                 @@+++++++@@                                               +@#++++%-                      +@*++++++@@         
                    @@                 %@#++++++@@.                                        @@++++++*@@                          -@#++++++@@.     
                       @@                 .@@++++++#@-                                  +@++++++@@:                                .@%++++++@@.  
                          @@                  @@++++++*@@                           *    =@+*@@                                       .@@++++++%@
                             @@.                 -@@++++++@@                    .:         @                                             .@@+++++
                                *@:                  @@++++++@@              @@@            @                                                @@++
                                   -@*                  @@*+++++%@=       %@++++@            @                                                  @
                                      .@@                  .@@+++++*@@ @@*+++++++@            @+                                                 
                                          @@                   @@+++++#++++++@@+++@+           -@                                                
                                             @@                   =@%+%++@@:  @++++*@            @                                               
                                                @@                    @#      @++++++@            @                                              
                                                   @@.                        @+++++++@            @.                                            
                                                      %@:                     @++++++++@:           @*                                           
                                                    #@*+@                     @+++++++++%@           :@                                          
                                                 @@+++++@                     @+++++++++++@            @                                         
                                              @@++++++*@@                     @++++++++++++@            @                                        
                                          .@@++++++#@=                        @+++++++++++++@.           @.                                      
                                       -@%++++++@@.                           @++++++++++++++@@           @#                                     
@@@@@@@@@@+:.                       @@*++++++@@                               @*++++++++++++++*@           :@                                  @@
