                           @=@@        @@-                       *@.      @@                         @@.         -###########.                   
                          @@              @@                        =@-     .@+                         #@:     .############@                   
                       @@                    @@.                       -@=   #@-                           -@*  @############@                   
                    @@                          @@..@.@@. @=@@@@          @@                                  .@#############@                   
                 @@                                #@=#=#%==#==#@=@#:@@@@                                      @#############@ %+=@              
              @@                                      =@*+*===@==#=@@=                                         @#######%#####@%#*@+@            @
           @@                                            .@@===+@@                         @@@@@               @#######%#####@=@@@@=#         @@ 
        @@                                                  .@@                         @@+++@+++@@            @#######@####@@      +@+      @   
     @@                                                                             .@@++++++@++++++@@:        @#######@#@.            .@@ .@    
    @@-                                                                          +@#++++++@@  @@*++++++*@*     @######@.                   *     
    @++*@@                                                                    @@*++++++@@        :@@+++++++@@  @##@@                          +  
    ##+++++@@                                                              @@+++++++@@               @@+++++++@@.                                
    .@*+++++++@@.                                                            @@++@@                     @@+%@-                                   
       :@@+++++++%@=                                                            @@.                       @@@.                                   
           @@+++++++*@@                                                            *@: #  @: @            @+++#@-                                
              *@#+++++++@@                                                            -@#=====            @++++++*@*                             
@.               .@@+++++++@@.                                                           :@%=+              @@++++++*@@                          
  +@-                @@*++++++#@-                                                           .@                 @@+++++++@@                       
     :@*                :@@++++++*@@                                                     -@@+@                    @@*++++++@@                    
        .@@                 @@+++++++@@                                               @@*++++@.                      +@*++++++@@                 
            @@                 #@#++++++@@.                                        @@++++++*@@                          -@#++++++@@              
               @@                 .@@++++++%@=                                  %@++++++@@.                                .@%++++++@@.       @@+
                  @@                  @@*+++++*@@                           @    *@+#@%                                       .@@++++++%@. @@++++
                     @@.                 -@@++++++@@                    :.        .@                                              @@++++++@++++++
                        #@:                  @@++++++@@.             @@@            @                                                @@+++@+++@@ 
                           -@*                  %@*+++++%@=       @@++++@            @                                                  @@@@%    
                              .@@                  .@@+++++*@@ @@++++++++@            @=                                                         
                                 .@@                   @@+++++@+++++*@@+++@=           +@                                                        
                                     @@                   =@@+@++@@.  @++++#@           .@                                                       
                                        @@                    @+      @++++++@            @                                                      
                                           @@.                        @+++++++@            @                                                     
                                              #@.                     @++++++++@.           @+                                                 * 
                                            @@*+@                     @+++++++++@@           -@                                              @===
                                         @@+++++@                     @+++++++++++@           .@                                           @*==#=
                                      @@++++++*@*                     @++++++++++++@            @                                          @====*
                                  :@@++++++%@.                        @+++++++++++++@.           @                                        %%=@- @
                               #@*++++++@@                            @++++++++++++++@*           @#                                     =@*     
@@*-:                       @@+++++++@@                               @+++++++++++++++*@           :@                                  @@        
+++++++++++++++**%@@@@@@@@@+++++++@@                                   %@*++++++++++++++@            @                              @@           
++++++++++++++++++++++++++*+++*@*                                         -@%++++++++++++@            @@   *  @@                 @@              
:*@@@@@@@@@@@@%#*+++++++++#@@:                                               .@@++++++++++@-       *    .@#%=@=#              @@                 
                        ...                                                      @@++++++++#@   +          =@=#%             @@.                 
                                                                                    @@++++++@@                @@            -%++@@.              
                                                                            @@         @@@@                 @@+@            @++++++@@.           
