+++*@%                                                            @@==@===            @++++++@@.                                           @@%   
+++++++@@                                                            %@+==              @@++++++%@:                                       -@%@   
 @@+++++++@@                                                            *@                 @@++++++*@=                                 %@*+++@   
    @@*++++++%@-                                                      @@+@.                   @@++++++*@%                           @@+++++++@   
       .@@++++++*@@                                               .@@++++%=                      @@+++++++@@                     @@+++++++#@=    
           @@+++++++@@                                         =@#++++++@@                          @@+++++++@@               @@+++++++@@.       
              +@%++++++@@.                                  =@*+++++#@@                                %@*++++++@@        .@@+++++++@@           
                  @@++++++%@:                           .:   @@++@@                                       +@*++++++@@  =@#+++++++@@              
 @@                  @@*+++++*@@                     @        .@                                             -@#++++++@++++++#@*                 
    @@                  .@@++++++@@              :@@            @                                               .@%+++@+++@@.                    
       @@.                  @@++++++@@        .@#+++@            @                                                 .@@@@@                        
          #@:                  *@#+++++%@- .@%+++++++@            @:                                                                             
             -@*                   @@+++++#++++++@@+++@:           %@                                                                            
                .@@                   @@*+#++#@@  @++++%@           .@                                                                           
                    @@                   :@@      @++++++@            @                                                                          
                       @@                         @+++++++@            @                                                                         
                          @@.                     @++++++++@.           @:                                                 .                     
                        .@@+@                     @+++++++++@#           *@                                              -=+=%                   
                     =@#++++@                     @++++++++++*@           .@                                           :=@=@+*=                  
                  @@*++++++@@                     @++++++++++++@            @                                          @+==*=@@                  
               @@+++++++@@                        @+++++++++++++@            @                                        @=+@@:@#=%@                
            @@++++++*@*                           @++++++++++++++@-           @-                                     *@@      .@@==@             
        :@@++++++%@:                              @*++++++++++++++#@           +@                                  @@            .@%%            
@@@@@@@*++++++@@                                   @@+++++++++++++++@           .@                              #@.                  @@          
++++++#++++@@                                         @@*++++++++++++@            @+   .  @-                 -@:                        @@       
++++++%+@@                                               +@*++++++++++@.       ..   =@=#=#=+              .@+                              @@    
   -+%*                                                     :@@++++++++%@    :         @@=@+             @@                                   @@ 
                                                               .@@++++++#@.               @@            .@++@@                                   
                                                        .@         @@@@.                #@*@            #*+++++@@                                
                                                       ##%@@@.@=%@@@                 @@++++@              @@++@@.                                
                                                       ==+=#+==@@                 @@++++++*@               @@                                    
                                                       ==%*=@@                .@@++++++#@=              @@                                       
                                                       -=@@                #@*++++++@@.              @@                  @@@=                    
                                                       @@@                -@*++++@@              .@@                  @@++@+++@@                 
                                                       @+++@@                *@@. @@==%#=:@+@@@@#                 .@@+++++@++++++@@:             
                                                       @*+++++@@                @@==#===+==*@-                 =@#++++*@@  *@#++++++*@@          
                                                       :@#+++++++@@                @@+==%@.                 @@*++++#@+        .@@+++++++@@.      
                                                          .@@+++++++@@                @.                 @@+++++%@:               @@*++++++*@@   
                                                              @@+++++++@@                            .@@+++++@@.                     .@@+++++++@@
                                                                 @@+++++++@%                      =@%+++++@@                             @@++++++
              :                                                     *@*+++++@@                 @@*+++++@@                                   =@%++
            .=*=*                   +@+@                               .@@#                 @@++++++@@                                          @
          .%=@+**%@              @=@===#+                            %@:                .@@++++++@@                                              
        .*==@@.@@==@@           @+%==#==@=@                       @@.                -@%+++++*@*                                                 
