#++++++*@%                                                            @-                =@*++++++@@                                 %@*+++@      
 .@@+++++++@@                                                      @@+*@                   -@#++++++@@                           @@+++++++@      
     @@+++++++@@                                               .@@+++++@                      .@%++++++@@.                    @@+++++++%@:       
        -@@++++++@@:                                        #@*++++++@@                          .@@++++++@@.             .@@+++++++@@.          
            @@++++++*@@                                  .@++++++%@*                                 @@++++++#@-       :@%+++++++@@              
               @@#++++++@@                           :.    @++@@                                        @@++++++*@* *@*++++++*@@                 
-                 .@@++++++@@.                    *         @                                              @@++++++@++++++#@=                    
 :@#                  @@++++++%@:             -@@            @.                                               @@+++@+++@@.                       
    .@@                  -@%+++++*@%       :@#+++@            @*                                                 @@@@@                           
        @@                  .@@++++++@@ .@#+++++++@+           -@                                                                                
           @@                   @@*+++++++++++@@#++*@            @                                                                               
              @@                   .@@++++%@@  +#++++@            @                                                                              
                 @@.                   @@      -#+++++@            @.                                                                            
                    +@-                        -#++++++@.           @#                                                                           
                       :@%                     -%+++++++%@           :@                                                 +                        
                     :@%+@                     :%+++++++++@            @                                              =+@*=.                     
                  *@*++++@                     :%++++++++++@            @                                            =#%@=#@                     
               @@+++++++@@                     :@+++++++++++@.           @.                                         :=%=@@=@%                    
            @@++++++*@@                        .@++++++++++++@%           @@                                       @==@@ @@=+@.                  
        .@@++++++#@+                           .@+++++++++++++*@           :@                                     @@@       @@#=@                
     -@%++++++@@.                               @+++++++++++++++@            @                                  @@             @@@               
@@@@*++++++@@                                   :@%++++++++++++++@            @                              %@.                  @@             
+++@++++@@                                         .@@++++++++++++@-           @@   %  @@                 =@.                        @@          
+++@*@@                                                @@++++++++++#@       ..    @@+=*==.             .@=                              %@.      
  ::                                                      @@+++++++++@    .         .@*==             @@:                                  %@.   
                                                             @@*+++++%@                +@             @++#@-                                  #@.
                                                     +@         +@@@.                @@*@            .@+++++#@-                                  
                                                     =*@@@=@=*@@@                 @@++++@              @@#+@@                                    
                                                     =#=+*=*@@                .@@++++++*@               @@                                       
                                                     =##=@@                -@%++++++%@:              @@                                          
                                                     =@@                %@*++++++@@.              @@                  @@@@                       
                                                    -%@+                @@++++@@              .@%                  @@++@+++@@-                   
                                                    :@++*@-                @@%.@@=====@@=@@#@+                 .@@+++++@+++++++@@                
                                                     @+++++#@.                @@=%===*=#%@:                 #@*++++*@#   @@+++++++@@.            
                                                     @@+++++++%@.               .@@==@@.                 @@+++++#@-         %@*++++++*@@         
                                                        @@+++++++@@                .                  @@+++++@@.               .@@+++++++@@.     
                                                           %@*++++++@@                            .@@+++++@@.                      @@*++++++#@%  
                                                              .@@++++++@@                      +@#+++++@@                             -@@+++++++@
           *-                                                     @@++++*@@                 @@++++++@@                                    @@+++++
          +#==.                  @@+@#                               @@+                 @@++++++@@                                          #@%+
        @=@=#%=@              @=%===#@                            @@.                .@@+++++*@%                                                 
     .%#=@@ +@##=@:  :      =@=@==%====@                       @@                 +@#+++++#@+                                                    
   @#*@@       .@@=@+==    @=+*==@@@@=%=@                   @@                 @@++++++%@:                                                       
  @@@              @@==@=@====@@      @@=+==@=.          @@                 @@++++++@@.                                                          
