         @@++++++*@@                         ..     @+@@.                                        .@%++++++@@:@@+++++++@@                         
            -@@++++++@@                   #          @.                                              @@+++++@+++++*@%                            
                @@++++++@@            .@@@            @%                                                @@++@++%@:                               
=                  @@#+++++%@-     .@@++++@#           .@                                                  @@@.                                  
 .@@                  .@@+++++*@@@@++++++++*@            @                                                                                       
    .@@                   @@++++++++++@@#*+++@            @                                                                                      
        @@                   =@@++%@%   **++++@            @.                                                                                    
           @@                           +*+++++@-           @@                                                                                   
              @@                        =#++++++#@           .@                                                                                  
                 @@                     =#++++++++@            @                                                =@@                              
              @@++@                     =%+++++++++@            @                                             .@#@==-                            
          :@@+++++@                     -%++++++++++@.           @:                                          #+=@@#=@                            
       @@*++++++@@                      :@+++++++++++@@           #@                                         @=##@=%=@                           
    @@+++++++@@                         :@++++++++++++*@           .@                                      .*=@@   @@==@                         
 @@++++++*@@                             @++++++++++++++@            @                                     @@.        @@=@                       
++++++#@=                                @+++++++++++++++@            @                                 =@.              @@                      
+++@@.                                    @@*+++++++++++++@+           @-                            :@-                    @@                   
@@                                           =@#+++++++++++*@           .@%..@= @%.               .@%                          @@                
                                                .@@++++++++++@       =     :@+@=@=.             @@                                @@             
                                                    @@++++++++@   *           @@=%             @@@                                   @@          
                                                       @@++++*@#                .@             @+++@@.                                  @@       
                                             .@+      .   @@-                =@#+@            .@++++++@@                                   @@    
                                             .==+=@@+@=@@.                @@*++++@               @@%@.                                        @@ 
                                             .@==+==@@                 @@+++++++@@              @@                                               
                                             .@==@@                .@@++++++*@*              @@                                                  
                                             .@@                +@#++++++@@.              @@                  %@**@@                             
                                             =%@@.               .@%++@@  ::           @@                  @@+++@++++@@.                         
                                             .@+++@@                :@@@==@====@=@@+@@                  @@+++++@@*++++++*@@                      
                                             .@++++++@@                =@==%=+==@@%                 :@@+++++@@    .@@+++++++@@.                  
                                              .@@+++++++@@                *@=*@-                 @@*++++*@%           @@*++++++#@#               
                                                  @@+++++++@@                                 @@+++++#@=                 :@@+++++++@@            
                                                     @@+++++++@@                          .@@+++++%@:                        @@+++++++@@=        
                                                        +@#++++++@@                    :@@+++++@@.                              *@#+++++++@@     
   %@@                                                     .@@+++@@                 #@*+++++@@                                     .@@+++++++@@: 
  @@=@=                 .@@===@                              .@@                 @@++++++@@                                            @@*++++++*
@=@=*=#==              @*==@@#@.                          -@=                 @@++++++@@                                                  .@@++++
@%@.  @@+==@  @.    .@@@==%=#==#@                      %@.                .@@++++++@@                                                         @@+
.        -@@=%@+:  ++=#==@@:*@*=+@@.                @@                 #@*+++++*@*                                                               
             @@==@@===@@       .@@=#==@@+   = @:+@@                 @@++++++#@-                                                                  
                @@@@*              @@==*===**=@@                 @@++++++@@.                                                                     
                                      +@*=+@*                .@@++++++@@                                                                         
                                                          +@*++++++@@                                                                            
                                                       @@+++++++@@                                                                               
                                                    @@+++++++@@                                                                                  
