                                                                        @######%###@   @@=#=%-                                                   
                                                                        @######@@         @@==:                                                  
                                           .@%@                         %###@.               +@-                                                 
                                           @=@=@                        %@                      .@%                                              
                                         .==#%%=@                       @%@.                       .@@                                           
                                         *@==+@=@.                      @   @@                         @@                        ..              
                                       @==%=+@=*==@                     @      @@                         @@                  #######@           
                                      @==+@=   @@==.                     :@#      @@                         %@.            .%#########.         
                                     @+@-         @@                        .@@      @@                         =@=        *#####%#####@         
                                   =@-               @@.                       .@@      @@                         .@@     ######@#####@         
                                +@:                     *@:                       .@@ :@%                             .@@ @######@#####@         
                             +@:                           -@=*@@=@:@===#*  .      @@.                                   =#######@#####@   @     
                          #@.                                 .@%=%=@==+%==@==@=@@                                       =#######@#####@ @=@=:   
                       @@.                                        @@==%===%==@%                        :                 =#######@#####@+==**%*  
                    %@.                                              @@==@@.                        @@*#+@@.             +#######@#####@@@: +@#  
                 %@.                                                                             @@++++@++++#@=          *#######@###%@        .@
              @@                                                                              @@++++++@@*++++++*@@       %#######@@=             
              +#@@                                                                        .@@++++++@@    .@@+++++++@@    @#####@.                
              .@+++@@                                                                  +@#++++++@@           @@+++++++@@ @#%@                    
               @++++++@@.                                                            -@*+++++@@                 @@*+++++@@                       
               :@@+++++++#@*                                                            -@@@                       -@@@                          
 @@.               @@++++++++@@                                                            :@#                      .@*@@                        
    @@.               #@#+++++++@@                                                            .@@=@=@%@%=           :%++++@@                     
       +@-               .@@+++++++@@.                                                           .@@==@==           :@*++++++@@                  
          :@%                @@*++++++#@*                                                            @@=:              +@*++++++@@               
             .@@                -@@+++++++@@                                                          @@#                 -@#++++++@@            
                 @@                 @@+++++++@@                                                   .@@+++@                    .@@++++++@@.        
                    @@                 #@*++++++@@.                                            -@%++++++@                       .@@++++++@@.     
                       @@                 .@@++++++#@+                                      @@*+++++*@@                             @@++++++#@-  
                          @@.                 @@+++++++@@                                * @+++++@@:                                   @@++++++*@
                             +@:                 -@@++++++@@                         #      @*@@                                          @@+++++
                                :@*                  @@++++++@@.                 ..          @*                                              @@++
                                   .@@                  %@*+++++#@*           -@*@=           :@                                                @
                                       @@                  .@@++++++@@     -@#++++#@            @                                                
                                          @@                   @@++++++@@@#+++++++++@            @                                               
                                             @@                   =@%++++*+++*@@+#+++@            @.                                             
                                                @@.                   @@++@@:   =#++++@.           @#                                            
                                                   %@:                          -#+++++@@           :@                                           
                                                      -@+                       -#+++++++@            @                                          
                                                        .@@                     :%++++++++@            @                                         
                                                     =@%++@                     :%+++++++++@            @.                                       
                                                  @@*+++++@                     :@++++++++++@*           @@                                      
                                               @@+++++++@@                      .@+++++++++++*@           .@                                     
                                            @@++++++*@#                         .@+++++++++++++@            @                                    
