@@@@@@@#*++++++++++++**@%                                               %@*++++++++++@        .    %@=*=+=@              -@:                     
                  :=%-                                                     -@#++++++++@+   ..         @@=#@            .@@                       
                                                                              .@@++++++@@.               @@            +#++@@                    
                                                                       -@         @@@@                 @@*@            @++++++@@                 
                                                                      @%*@@#.@=@@@@                 @@++++@             .@@++@@                  
                                                                      @=#=+#==@@                .@@++++++#@               @@                     
                                                                      @=*==@@                =@#++++++@@.              @@                        
                                                                      @+@+                @@*++++++@@              .@@                  @@@-     
                                                                      @@@                #@*++++@@              :@*                 .@@++@+++@@  
                                                                      @+++@@                %@@..@@==@+*+@=@@@@-                 :@%++++**++++++@
                                                                      @++++++@@                @@==+=*=#==@@.                 %@*++++#@=  @@*++++
                                                                      +@*+++++++@@                @@=#=@@                  @@+++++@@.        .@@+
                                                                         -@%+++++++@@                @                  @@+++++@@                
                                                                            .@@++++++*@#                            :@@+++++@@                   
                                                                                @@++++++*@*                      @@*+++++@@                      
                             +                                                     @@*++++*@:                 @@++++++@@                         
                           -=%=@                   %@*@                               :@@-                 @@++++++@@                            
                         :#=%%+=@@              %=@===#.                            @@.                .@@+++++*@*                               
                       .@==@@.@@==@@           @@@==@==%=:                       @@                 *@*+++++#@-                                  
                     @+=@@       @@=@%==@   .@==#==@@@=*=@                    @@                 @@++++++@@.                                     
                    @@@             =@*=+*===+==@@     #@+=@==@           .@@                 @@++++++@@.                                        
                  @@                   .@@==@@:           .@@=*#==@@=+=*@=                .@@++++++@@                                            
@              @@                                             @@==@=@@.                *@#++++++@@                                               
  @@        @@                                                   *@                 @@+++++++@@                                                  
     @@.    @*@%                                                                 @@++++++*@@                                                     
        =@*@*@@:                                                             .@@++++++#@+                                                        
                                                                           @#++++++%@:                                                           
                                                                             @@+@@.                                                              
@                                                                               @@                                                               
+@@                                                                                @@                                                            
.                                                                                     @@                                                         
@.                                                                                       @@                                                      
++#@*                                                                                      @@                                                    
++++++@@                                                                               .@@++@                                                    
@++++++++@@.                                                                        @@*+++++@                                                    
  @@*+++++++*@#                                                                      .@#+#@@                                                     
     -@@++++++++@@                                                                      +@.                                                      
         @@++++++++@@:                                                                     @@                                                    
            @@*+++++++*@@                                                                     @@                                                 
               :@@++++++++@@                                                                   @@@                                               
                   @@++++++++@@-                                                            @@+++@                                               
                      @@*+++++++*@@                                                      @@++++++@                                               
                         .@@++++++++@@                                                @@+++++++@@                                                
                             @@++++++++%@=                               @@@@.     @@++++++#@+                                                   
