                                                                                          @++++@@                @@#@==@==+*=#+*@+               
                                                                                          @+++++++@@                @@==@@==#@:                 %
                                                                                           *@#+++++++@@                @@@@.                 @@++
                                                                                              .@@+++++++@@                                @@+++++
@                                                                                                 @@++++++*@+                         .@@+++++@@ 
@                                                                                                    @@++++++*@=                   #@*+++++@@    
@                                              @#+@                     .                               *@#+*@@                 @@++++++@@       
-@+                                           @*==%%                @@==@=@                              =@=                 @@++++++@@          
   .@@                                      -+#=@@=%=#             @===*%*=@%                         @@.                .@@+++++*@%             
       @@                                 @*=@@    @@==@ .@@    :%=*=@#=+@==@                      @@                 +@#+++++*@+                
          @@.                           @=@@          @@==%#@- @@=@=#@@  @@=*=@@+:              @@                 @@++++++%@:                   
             *@=                      .@@                :@@==%==%@@        -@%=%==%@.  @ @@@@@                 @@++++++@@.                      
                .@@                 @@                       @@@.               @@=====*%+@+                .@@++++++@@                          
+@@                 @@           @@                                                @@=%@:                +@#++++++@@                             
++++@@                 @@.     @@-                                                                    @@+++++++@@                                
+++++++@@                 #@:  @++*@                                                               @@++++++*@@                                   
 *@#++++++@@:                :@@@.                                                             .@@++++++*@%                                      
    .@@++++++*@%                                                                               @@++++#@-                                         
        @@+++++++@@                                                                               @@.                                            
           @@+++++++@@                                                                               @@                                          
              *@*++#@.                                                                                  @@                                       
                 @@                                                                                        @@                                    
                 @++@@.                                                                                       @@                                 
                 %*++++*@@                                                                                   @@%:                                
                 *@++++++++@@                                                                            :@@+++*#                                
                    @@++++++++@@:                                                                       @%+++++@@                                
                       #@#+++++++*@@                                                                      -@@*                                   
                          .@@++++++++@@.                                                                     %@.                                 
                              @@++++++++%@=                                                                     @@                               
                                 *@#++++++++@@                                                                     @@                            
                                    .@@++++++++@@.                                                               @@+@                            
                                        @@++++++++#@#                                                         @@++++@.                           
                                           +@#++++++++@@                                                   @@+++++++@=                           
                                               @@++++++++@@.                                  @         @@+++++++@@                              
                                                  @@++++++++*@@                            @@+@+@@#  @@++++++#@+                                 
                                                     =@%++++++++@@                     :@@++++@++++#++++++@@.                                    
                                                         @@++++++++@@:              @@*++++++@@++++%+++@@                                        
                                                            @@*+++++++*@@        @@+++++++@@    .@@@@*                                           
                                                               -@@++++++++@@  @@+++++++@@                                                        
                                                                   @@+++++++*++++++*@@                                                           
                                                                      @@*+++#+++#@=                                                              
                                                                         :@@@@@.                                                                 
                                                                                                                                                 
                                                                                                                                                 
