                                                                               @=#@=@@*+@@@                 @@++++#+              @@+@@          
                                                                               @%==#=+@@                .@@++++++*@.              @@             
                                                                               @*==@@                -@%++++++@@:              @@                
                                                                               @@#                @@*++++++@@              .@@                  @
                                                                               @@@.               .@#+++@@  .           .@%                 .@@++
                                                                               @+++@@                -@@@@=#==+=@@=%@+@=                 :@@++++*
                                                                               @++++++@@                +@%=@==#==#@:                 *@*++++*@* 
                                                                               -@@+++++++@@                %@==@@.                 @@+++++%@-    
                                                                                   @@+++++++@@                                  @@+++++@@.       
                                                                                      @@+++++++@@                           .@@+++++@@           
                                                                                         %@*++++++@@                     #@*+++++@@              
                                     @@                                                     -@%+++*@@                 @@++++++@@                 
                                    @@#=@                 .@@+=@                               =@=                 @@++++++@@                    
                                  @=%==@=+@             @=*==@=@                            @@.                .@@+++++*@#                       
                               .@*=@@  @@==+@  @      @@=@%=@@==%+                       @@                 +@#+++++#@=                          
:                            #%=@@        *@*=@*=%   @=+##=@@@@+==@=                  @@                 @@++++++@@.                             
 :@@                        @@@              .@@%=%=+=%=@@      .@@=@==@@:      . .@@                 @@++++++@@.                                
     @@                   @@                     @@=@@:             @@=====@===+@*                .@@++++++@@                                    
        @@             @@                                              %@+==@@.                +@#++++++@@                                       
           @@.      %@                                                    ..                @@+++++++@@                                          
              -@*   @++@@                                                                @@+++++++@@                                             
#                .@@@@@:                                                             .@@++++++*@*                                                
++@@                                                                               :@++++++#@-                                                   
+++++@@                                                                               @@@@.                                                      
@*++++++@@.                                                                              @@                                                      
  -@%++++@@                                                                                 @@                                                   
     .@@.                                                                                      @@                                                
      @+%@=                                                                                       @@                                             
      *#+++*@@                                                                                     @@=                                           
      :%+++++++@@.                                                                             .@@++*@                                           
        @@++++++++#@+                                                                        @*++++++@                                           
           =@%++++++++@@                                                                       @@#@@                                             
              .@@++++++++@@.                                                                     .@+                                             
                  @@*+++++++*@#                                                                     =@.                                          
                     -@%++++++++@@                                                                     @@.                                       
                         @@++++++++@@.                                                                 @@@.                                      
                            @@*+++++++*@@                                                           @@+++@.                                      
                               :@@++++++++@@                                                     @@++++++*%                                      
                                   @@++++++++@@:                                              @@+++++++@@                                        
                                      @@*+++++++*@@                              @@@@@*    @@++++++#@*                                           
                                         .@@++++++++@@.                      :@@+++@++++@@++++++@@.                                              
                                             @@++++++++%@=                @@*++++++@++++*++++@@                                                  
                                                @@*+++++++*@@          @@+++++++@@  -@@+%#@%                                                     
                                                   .@@++++++++@@.  .@@+++++++@@                                                                  
