                       @@+@                      @+++++++++@            @                                               @+@=-                    
                    @@++++@                      @++++++++++@            @                                            @##*=@@                    
                :@@++++++@@                      @+++++++++++@.           @:                                          @%=+#=@-                   
             @@*++++++@@                         @++++++++++++%@           *@                                       @=%@@.@@=*@                  
          @@+++++++@@                            @++++++++++++++@           .@                                     @#@.      @@%=@               
       @@++++++*@@                               @+++++++++++++++@            @                                  :@-            @@@              
@@@@@@++++++#@+                                  =@#++++++++++++++@.           @                              .@*                  @@            
++++@++++@@.                                        .@@++++++++++++@*           @@   :  @*                  @@                        @@         
++++@+@@.                                              .@@++++++++++*@        #    @@*=#==@              @@                              @@.     
 .-*@                                                      @@+++++++++@    @         .@++==            @@.                                  @@.  
                                                              @@+++++++@                %@:            @++%@:                                  @@
                                                      .@         #@*@#                .@@@.            @+++++#@:                                 
                                                      =%@@@ @+%@@@-                =@#+++@.             @@*+*@+                                  
                                                      +=#==*@%@.                @@*++++++@               *@:                                     
                                                      ##==@@                 @@+++++++@@              @@.                                        
                                                      %@@                .@@++++++*@*              @@                  -@@@                      
                                                      @@-                @@++++@@.              @@                  @@*+*+++@@.                  
                                                      @++#@:                @@- @@*==@=@@%%@%@@                  @@+++++@++++++*@@               
                                                      @+++++%@.               .@%#@====*@=@@                  @@+++++@@  .@@+++++++@@.           
                                                      @@+++++++@@.               .@%===@%                 :@%+++++@@         @@*++++++*@@        
                                                         @@+++++++@@                :+                 @@*++++*@@               :@@+++++++@@     
                                                            @@*++++++@@                             @@+++++*@#                      @@+++++++%@* 
                                                               -@%++++++@@                      .@@+++++#@-                            +@@+++++++
            .:                                                     @@+++++@@                 :@%+++++@@.                                   @@++++
           @===*                  .@@@#                               @@@                 #@*+++++@@.                                         @@*
         @=+=%==@.             @=*==#%@                            .@@                 @@++++++@@                                                
       :@=+@-#@+#+@.         .*=====+=+=@                       -@+                 @@++++++@@                                                   
    .@@+@-      .@@*@===.   @=%=*=+@@%=*=@                   %@.                .@@++++++@@                                                      
   @+@=             @@=+@=%=@==@@.     @@=*==@:           @@                 %@*+++++*@%                                                         
 -@-                   @@=*=@@            @@==*===@#=@=@@                 @@++++++#@=                                                            
=                         .                  -@@=#*=@@                 @@++++++%@:                                                               
                                                 @#                .@@++++++@@.                                                                  
                                                                *@*++++++@@                                                                      
                                                             @@+++++++@@                                                                         
                                                          @@+++++++@@                                                                            
                                                            .@#+@@                                                                               
                                                               -@-                                                                               
                                                                  -@:                                                                            
                                                                     +@.                                                                         
                                                                        *@.                                                                      
                                                                          =@.                                                                    
                                                                       @@++@.                                                                    
                                                                   .@@+++++*+                                                                    
                                                                     @@++@@.                                                                     
