                                                                                 .+==@==@@                -@@++++++%@:              @@           
                                                                                 .==+@*                @@*++++++@@              .@%              
                                                                                 -@:                @@+++++++@@              :@*                 
                                                                                 #*#@:                @@+*@@  @%  .   +   +@-                 .@@
                                                                                 +*+++%@.                @@@==+===+*=+@@@.                 #@*+++
                                                                                 =%++++++@@.               .@#=#=@==@@                  @@+++++%@
                                                                                   @@+++++++@@                .@*@@                  @@+++++@@.  
                                                                                      @@+++++++@@                                .@@+++++@@      
                                                                                         *@*++++++@@                          +@#+++++@@         
                                                                                            .@@++++++@@                    @@++++++@@            
                                       @+@                                                      @@++#@=                 @@++++++@@               
                                      @%=+*                 @@+===+                              @@.                .@@+++++*@#                  
                                    @=+=@==++              %====%+@@                          @@                 +@#+++++#@-                     
=                                .@=@@@   =@#==: .@-    @*=+==#===+=@                      @@                 @@++++++@@.                        
 .@@                           .*=@@         .@@=++@%  @==%==@@ .@@=%%@#.              .@@                 @@++++++@@.                           
     @@                       @@@                @@==*@==%@+        @@====%@@  .@.@@@@*                .@@++++++@@                               
        @@                  @@                      %@@@               @@+=@===*=%@:                =@#++++++@@                                  
           %@:           @@                                               .@@*@@.                @@*++++++@@                                     
              :@@      @@                                                                     @@++++++*@%                                        
@                 @@   @++@@                                                              .@@++++++#@=                                           
++@@                 @@@@                                                              -@%++++++@@:                                              
+++++@@                                                                               :@#++++@@.                                                 
@*++++++@@.                                                                              :@@                                                     
  .@@++++++#@=                                                                              -@:                                                  
      @@+++@@                                                                                  =@:                                               
         @=                                                                                       *@.                                            
         @++@@                                                                                       #@.                                         
         @+++++@@                                                                                   .@@@                                         
         @++++++++#@*                                                                            #@#+++@                                         
           =@%++++++++@@                                                                       @@+++++*@                                         
               @@++++++++@@.                                                                      @@@:                                           
                  @@*+++++++#@@                                                                      @@                                          
                     -@%++++++++@@                                                                     .@*                                       
                         @@++++++++@@.                                                                    :@:                                    
                            @@*+++++++*@@                                                                @@+@                                    
                               :@@++++++++@@                                                          @@++++@                                    
                                   @@++++++++@@:                                                   @@+++++++@                                    
                                      @@*+++++++*@@                                   .         @@++++++*@%                                      
                                         :@@++++++++@@                            :@@++*@@   @@++++++@@.                                         
                                             @@++++++++@@=                     %@*+++*+++++@++++++@@                                             
                                                @@*++++++++@@               @@+++++++@*++++@++*@@                                                
                                                   .@@++++++++@@         @@+++++++@@    @@@@@:                                                   
                                                       @@++++++++#@* .@@++++++*@@                                                                
                                                          #@*+++++++@++++++#@=                                                                   
