                    @@++++++#@*                       -%++++++++++++@            @                                        @=+=@@@=+=.            
                :@%++++++@@.                          :@+++++++++++++@.           @.                                     @=@@     @@=+@*         
             #@*++++++@@                              .@++++++++++++++@@           @@                                   @@           @@==        
@@@@@@@%*:@@+++++++@@                                  @@++++++++++++++*@           .@                               @@                 @@.      
++++++++++@++++*@@                                        @@+++++++++++++@            @                           @@                       #@.   
++++++++++@+#@+                                              @@+++++++++++@         +   @@==+@=%.              %@.                            *@:
 ..+%@@@@@@.                                                    @@+++++++++@*    -         @@===             @+                                  
                                                                   @@*++++++*@.              .@+             @+*@+                               
                                                                      -@#+@@                 @@@             @++++*@*                            
                                                           .==::@ %@=:.@@                 @@+++@             %@#+++@@                            
                                                           .==#*=#==@@                .@@++++++@                @@                               
                                                           .==#=+@%                #@*++++++@@.             .@@                                  
                                                           .=#@-                @@+++++++@@              :@*                  @@                 
                                                           #@%                @@++++++@@              +@-                 .@@+@++@@-             
                                                           =#+*@#                @@@# @=%=@@@.:@@=@@@.                 +@#++++@++++++@@          
                                                           .%++++*@=                @@=@%=*+=#==@@                  @@*++++%@: @@+++++++@@.      
                                                           .@+++++++*@-                @@@===@@                  @@+++++@@.       @@#++++++*@@   
                                                              @@+++++++#@.               .@@                 .@@+++++@@              .@@+++++++@@
                                                                 +@#++++++%@.                             =@#+++++@@                     @@*+++++
                                                                    .@@++++++@@                        @@*+++++@@                           :@@++
                                                                        @@++++++@@                  @@+++++*@@                                  @
                 ===@                    @@+                               @@@@.                 @@+++++*@#                                      
               @=@%=%@.              @==@==*@                             @@                 -@%+++++#@-                                         
              @=+@@@#=%@.           .==@======@                        @@                 @@*+++++@@.                                            
           @==@@      @@=@@@=@    @%==*==@@=%=@                    .@@                 @@++++++@@                                                
         :=@@            @@==@=@@=+==+@@    @@=*==#@            :@#                .@@++++++@@                                                   
        @@                  #@+=#=@@.          %@+##===@%@@@=#@:                :@%++++++@@                                                      
     @@                        .@                 .@@=+=%=@@.                %@*++++++@@                                                         
  @@                                                  @@@                 @@++++++*@%                                                            
 @@@.                                                                  @@++++++*@=                                                               
 @+@@:                                                             :@@++++++%@:                                                                  
#@                                                              @@*++++++@@.                                                                     
                                                                  @@++@@                                                                         
                                                                    .@%                                                                          
                                                                       .@@                                                                       
                                                                          .@+                                                                    
                                                                             .@+                                                                 
                                                                                :@                                                               
                                                                             -@@+@                                                               
                                                                          @@*++++@                                                               
+@@.                                                                      @@+++#@@                                                               
++++#@#                                                                      @@                                                                  
++++++++@@                                                                      @@                                                               
 @@++++++++@@.                                                                     @@                                                            
