    -@+                   @@++++++++@@=*#+++@            @+                                                                                      
       .@%                   @@##@@    +#++++@#           -@                                                                                     
           @@                          -#+++++*@            @                                                                                    
              @@                       -#+++++++@            @                                                                                   
               @@@                     -%++++++++@            @.                                               @@@@                              
            @@+++@                     -%+++++++++@-           @*                                            @==%++@                             
         @@++++++@                     :%++++++++++#@           :@                                          #=*=%=@@                             
     :@@++++++@@.                      :@++++++++++++@            @                                         @=+%@+++=.                           
  *@*++++++@@                          .@+++++++++++++@            @                                      @++@:   :@%@#@                         
@+++++++@@                              @++++++++++++++@.           @.                                   .@+         .@#@                        
++++*@@                                 @+++++++++++++++@@           @#                                @%               .@@                      
+#@+                                      @@+++++++++++++*@           :@                            @@                     .@@                   
.                                            @@*+++++++++++@          @ -@@@@@#%=.               @@                           .@@                
                                                =@#+++++++++@.     @       @@=#=*.            @@                                  @@             
                                                   .@@+++++++@+ #             @@=             @+@@                                   @@          
                                                      .@@+++@@                 @@             @++++@@                                   @@       
                                            .==. .  @@. .@@                .@@++@             @@+++++@@                                    @@    
                                             ==*++=@=+@+                +@#+++++@                @@%                                          @@ 
                                             =====%@:                @@+++++++@@              =@=                                                
                                             ==@@.                @@+++++++@@              #@.                 ..                                
                                            -@                 @@++++++*@%              @@.                 -@%*+*@%                             
                                            -%+@@                #@*@@:  @@: @  .@   @@.                 @@*+++@+++++@@                          
                                             @++++@@                @@=%==#==%=%=@@@                  @@+++++@@@@*++++++#@*                      
                                             @+++++++@@                @@=+%===@@                 .@@+++++@@      :@@+++++++@@                   
                                              =@#+++++++@@                @@@@                 :@%+++++@@             @@+++++++@@-               
                                                 .@@+++++++@%                               %@*+++++@@                   *@#+++++++@@            
                                                     @@+++++++@#                         @@+++++*@%                         .@@+++++++@@.        
                                                        @@*+++++*@=                   @@+++++#@=                                @@*++++++*@@     
  @=+@                     +                               =@#+@@                 :@@+++++%@:                                      .@@+++++++@@. 
:@#==*:                @*=%@=@                              @@                 %@*+++++@@.                                             @@+++++++#
#*=@@=#=.             *==@==@=@=                        .@@                 @@++++++@@                                                    =@%++++
@@    @@==- %=@    @=%==#===@==@                     :@%                 @@++++++@@                                                           @@+
         #@+=%+@@.@=+==@@*  @@===%@@:             %@:                .@@++++++@@                                                                 
            .@@==@==@@         :@@=@===@: @@%@@@@.                *@*++++++@@                                                                    
                @@@                @@=====@+@@                 @@++++++*@#                                                                       
                                      @@+@@                 @@++++++#@-                                                                          
                                                        .@@++++++@@.                                                                             
                                                     #@#++++++@@.                                                                                
                                                  @@+++++++@@                                                                                    
                                                  @@++++@@                                                                                       
                                                     @@                                                                                          
                                                        @@                                                                                       
                                                           @@                                                                                    
                                                              @@                                                                                 
