                                                                                    @=*@+                @@+++++++@@              .@%            
                                                                                    @.                @@+++++++@@              -@=               
                                                                                    @+@@                -@**@@  #@= +.  @   #@.                 -
                                                                                    @++++@@                +@=*==*==@===*@@                  @@*+
                                                                                    @+++++++@@                %@==*#==@@                  @@+++++
                                                                                     :@@+++++++@@                @@@@                 .@@+++++@@.
                                                                                         @@+++++++@@                               :@%+++++@@    
                                                                                            @@+++++++@@                         #@*+++++@@       
                                                                                               %@*++++++@@                   @@++++++@@          
                                         @==@                     -                               :@@+%@-                 @@+++++*@%             
                                        @===+*                @@=+@=@                              @@.                .@@+++++#@+                
                                      %===@@=*=-             @==*=*%=@@                         @@                 %@*+++++@@:                   
 @@.                                @==@@    @@==@ =%@    @=+==@===#==@                      @@                 @@++++++@@.                      
    #@-                           %=@@          =@#=%=@%.@%=*=*@@  @@++*@@@*             .@@                 @@++++++@@                          
       .@@                      :@@                 @@==%==@@-        .@@=#==+@= -@-@@@@=                .@@++++++@@                             
           @@                 @@                       @@@                @@==+==%@@@.                *@*++++++@@                                
              @@           @@                                                #@*@@                 @@+++++++@@                                   
.                %@.     @@@                                                                    @@++++++*@*                                      
+@@:                :@*  @++%@                                                              .@@++++++#@-                                         
++++*@%                .@@@                                                              *@#++++++@@.                                            
@+++++++@@                                                                               @@++++@@                                                
  @@+++++++@@                                                                               @@                                                   
     %@*++++++@@                                                                               @@                                                
        :@@++@@                                                                                   @@                                             
           @@.                                                                                       @@                                          
           @++#@*                                                                                       @@                                       
           @++++++@@                                                                                  .@@@.                                      
           #@++++++++@@.                                                                           %@*+++#*                                      
              @@*+++++++#@%                                                                       @@++++*@*                                      
                 -@%++++++++@@                                                                      .@@.                                         
                     @@++++++++@@.                                                                     -@:                                       
                        @@*+++++++*@@                                                                     #@.                                    
                           :@@++++++++@@                                                                     @@                                  
                               @@++++++++@@:                                                               @@+@                                  
                                  @@*+++++++*@@                                                         @@++++@.                                 
                                     .@@++++++++@@.                                                  @@+++++++@:                                 
                                         @@++++++++%@=                                 .@         @@++++++#@*                                    
                                            @@*++++++++@@                           -@%+@+*@@  @@++++++@@.                                       
                                               .@@++++++++@@.                    %@*++++%++++%++++++@@                                           
                                                   @@++++++++#@*              @@+++++++@@++++@++*@#                                              
                                                      %@#++++++++@@        @@+++++++@@     @@@@.                                                 
                                                         .@@++++++++@@.-@%++++++*@%                                                              
                                                             @@+++++++*++++++%@:                                                                 
                                                                *@#+++@+++@@.                                                                    
