                                                                                @@++++++++@  *            #@=@            .@@@                   
                                                                                   @@++++@@                 @@            %*+++@@.               
                                                                         @#@     -@  .@@                .@@++@            @@++++++@-             
                                                                         @====@=%=+@#                =@%+++++@               %@@@                
                                                                         @===+=#@-                @@*++++++@@              -@+                   
                                                                         @==@@.                @@+++++++@@              *@:                      
                                                                         @@.                @@++++++*@%              @@.                 :@@@+@@ 
                                                                         @+%@.               .@@+%@-  @#  -   =   @@                  @@*+++@++++
                                                                         @++++@@                .@%@==%=+=%=*=@@@                  @@+++++@@@%+++
                                                                         @+++++++@@                :@*=#*+==@@                  @@+++++@@     .@@
                                                                           @@+++++++@@                -@%@@                 :@@+++++@@           
                                                                              @@+++++++@@                                #@*+++++@@              
                                                                                 %@*++++++@@                          @@+++++*@%                 
                                                                                    -@%++++++@@                    @@+++++*@+                    
                              .@*@                                                     .@@++@@.                .@@+++++%@:                       
                             =@=#+@                 @@@*==.                              @@                 #@#+++++@@.                          
                            @*==@===@             :%=@#=@=@@                          @@                 @@++++++@@                              
                         +#=+@%   #@+==  @@.    @+#==*#=+=%+@                     :@%                 @@++++++@@                                 
                       @==@%         .@@=*+@@ .@==+=+@# -@@=%%@@-              +@-                .@@++++++@@                                    
                      @@@                @@==*#==@@.        @@=+==#@%  *=#@@@@.                +@#++++++@@                                       
@@                 .@%                      @@@@               @@==%=@=@=@@                 @@++++++*@#                                          
   @@.          .@@                                               :@@%@@                 @@++++++#@=                                             
      -@*      @@                                                                    .@@++++++%@.                                                
          @@  -%++@@                                                              +@#++++++@@                                                    
             @@@@                                                              @@*++++++@@                                                       
                                                                              -@*++++@@                                                          
@@.                                                                              +@@                                                             
+++%@:                                                                              *@.                                                          
+++@@                                                                                  %@.                                                       
 @:                                                                                       %@.                                                    
 @+*@@                                                                                       @@                                                  
 @+++++@@                                                                                   +@%@                                                 
 @++++++++%@-                                                                            @@++++@                                                 
   #@#+++++++*@@                                                                       @@+++++#@                                                 
      .@@++++++++@@.                                                                      @@@                                                    
          @@++++++++#@+                                                                      @%                                                  
             *@#++++++++@@                                                                     .@=                                               
                 @@++++++++@@.                                                                    +@.                                            
                    @@++++++++#@*                                                                @@+@                                            
                       +@%++++++++@@                                                         .@@++++@                                            
                           @@++++++++@@.                                                  .@%++++++*@                                            
                              @@++++++++*@%                                  :         .@%++++++@@.                                              
                                 -@@++++++++@@                            @@*%+*@@  :@%++++++@@                                                  
                                     @@++++++++@@:                     @@++++@+++++@+++++*@@                                                     
