.@@                   @@++++++@++++++#@+++@            @                                                                                         
   .@@                   @@*++@+++@@  @++++@            @.                                                                                       
       @@                   .@@@.     @+++++@.           @=                                                                                      
          @@                          @++++++@%           =@                                                                                     
             @@.                      @+++++++*@            @                                                                                    
             @@@                      @+++++++++@            @                                               @===@                               
         .@@+++@:                     @++++++++++@            @                                            @=++#%%                               
      +@#++++++@%                     @+++++++++++@=           @+                                          @%====*                               
   @@+++++++@@                        @++++++++++++#@           -@                                        @=%@@@@=@@                             
@@+++++++@@                           @++++++++++++++@            @                                     .=@@      @@==@                          
+++++*@#                              @+++++++++++++++@            @                                   %@.           @@@                         
++@@:                                 @@+++++++++++++++@.           @.                              -@:                 @@                       
@                                        %@*++++++++++++@@           @@                          .@+                       @@                    
                                            :@%+++++++++++@         -  .@*@=@@+@              .@@                             @@                 
                                               .@@+++++++++@     =        +@=@=@            +@                                   @@              
                                                   @@+++++++@ #              @@@            @++@@                                   @@           
                                                      @@+#@=                :@%@            @+++++@@                                   @@        
                                           @=@ @  @+@@%@.                #@*+++@             @@+++%@:                                     @@     
                                           @==%==+=@@.                @@+++++++@               @@.                                           @@. 
                                           @=%==@@                 @@++++++*@@              @@                                                  @
                                           @=@@                :@@++++++#@-              @@                  *@*                                 
                                           @@.                @%+++++@@.              @@                  @@++@++@@                              
                                           @++@@                :@@@  @@=%@@@ @@:@@@@                  @@+++++++++++%@=                          
                                           @+++++@@                -@+=*==@=#*==@@                 .@@+++++@@ =@%+++++++@@                       
                                           @%+++++++@@                *@==*=+@+                 *@#++++*@@        @@+++++++@@.                   
                                             .@@+++++++@@                %@:                 @@+++++*@*              %@*++++++*@@                
                                                 @@+++++++@@                              @@+++++%@-                    .@@+++++++@@.            
                                                    @@*++++++@@                       .@@+++++@@.                           @@*++++++#@@         
                                                       -@%++++++@                  =@#+++++@@                                  :@@+++++++@@      
@=*=@                   .@@.                              .@@@@                 @@*+++++@@                                         @@+++++++%@*  
=**=@@               @=++=*+                             :@#                 @@++++++@@                                               +@#+++++++@
#@@@==@@            @+=+@#=@=%                        *@:                 @@++++++@@                                                      @@+++++
     #@+@@@==@   %=+==*=%@=+==@                    @@.                =@%+++++*@%                                                            @@*+
        .@@=+=#@@=@==@@    -@@=@*+@             @@                 @@*+++++*@=                                                                  .
            @@====@@           @@===%=@@@=@#=@@                 @@++++++%@:                                                                      
               @.                 @@==@===@@                .@@++++++@@.                                                                         
                                     :@@=                -@%++++++@@                                                                             
                                                      %@*++++++@@                                                                                
                                                   @@+++++++@@                                                                                   
                                                @@+++++++@@                                                                                      
                                                 %@++*@#                                                                                         
                                                    %@.                                                                                          
                                                       @@                                                                                        
                                                          @@                                                                                     
