         @@.                   @@**@@    @+++++@.           @=                                                                                   
            *@-                          @++++++@#           =@                                                                                  
               :@*                       @*++++++*@            @                                                                                 
                 *@@                     @*++++++++@            @                                                @#@.                            
              @@+++@                     #*+++++++++@            @.                                            @==#@=-                           
           @@++++++@                     #*++++++++++@-           @*                                          @==*%=+=                           
       .@@++++++#@=                      **+++++++++++#@           -@                                         @=##@=@=+                          
    :@%++++++@@.                         +#+++++++++++++@            @                                      @%=@+   @@=*@+                       
 @@*++++++@@                             =#++++++++++++++@            @                                     @@         @@=@                      
+++++++@@                                -%+++++++++++++++@.           @.                                @@               @@                     
+++*@@                                     .@@+++++++++++++@@           @#                            @@                     %@.                 
#@=                                            @@+++++++++++*@          % @@@@@@.==                @@                           #@.              
                                                  @@++++++++++@      +       @@==+=             #@.                                *@:           
                                                     @@*+++++++@. -            .@*+             @*@=                                  +@:        
                                                        *@*+++@@                 @@            .@+++*@+                                  -@=     
                                              =*+     -@  .@@                 @@++@            -@*+++++@@                                   :@+  
                                              :====%=#==@@                .@@+++++@               .@@@                                         .@
                                              .===*=+@+                *@*++++++@@.             .@@                                              
                                              .==%@:                @@+++++++@@              -@+                                                 
                                              +@.                @@++++++*@@              *@:                 .@@@+@@.                           
                                              #**@*                @@+#@+  @@  =   %   @@.                 +@#+++@++++*@@                        
                                              +*+++*@=                @@%*=+#==%=+=@@@.                 @@+++++@@@@+++++++@@.                    
                                              =%++++++*@:                @@=#**==@@                  @@+++++@@      @@*++++++#@*                 
                                                @@+++++++#@.                @%@@                 .@@+++++@@            :@@+++++++@@              
                                                   %@*++++++%@.                               =@#+++++@@                   @@+++++++%@=          
                                                      :@%++++++@@                          @@*+++++@@                         *@#+++++++@@       
                                                         .@@++++++@@.                   @@+++++*@@                               .@@+++++++@@.   
    @=@:                                                     @@++@@.                .@@+++++*@+                                      @@*++++++*@@
  .@%==%                 @@++==+                              @@                 =@%+++++%@:                                            .@@++++++
 @+#=@+=#+              %==*=++@@.                         @@                 @@*+++++@@.                                                   @@+++
=@@@   .@@==. =@%    @=*===*==+*=@                     .@@                 @@++++++@@                                                          =@
@          @@==+@@. @==+=+@@  @@=%+@@+              -@*                 @@++++++@@                                                               
              @@===%==@@.        @@==+=+%@  =@-@@@@:                :@%++++++@@                                                                  
                 -@@@               -@%=%===%=@@                 @@*++++++@@                                                                     
                                        @@*@@                 @@++++++*@%                                                                        
                                                           @@++++++#@=                                                                           
                                                       :@@++++++%@.                                                                              
                                                    %@*++++++@@.                                                                                 
                                                    @@++++@@                                                                                     
                                                      .@@                                                                                        
                                                         .@%                                                                                     
                                                            .@+                                                                                  
                                                               :@=                                                                               
                                                                  -@-                                                                            
