                     +@#+++++@                     -%++++++++++@:           @=                                          #==@@+=@                 
                  @@+++++++@@                      :@+++++++++++#@           =@                                         @=*@@=@=@                
               @@+++++++@@                         .@+++++++++++++@            @                                      .*=@@   @@==@.             
            @@++++++#@*                            .@++++++++++++++@            @                                     @@         @@=@            
        :@@++++++@@.                               .@+++++++++++++++@.           @                                 %@.              @@           
+++++*#@++++++@@                                     =@#+++++++++++++@%           @*                            =@.                    @@        
+++++++@+++@@                                           .@@+++++++++++*@          . @@--@# %+.               .@=                          @@     
@@@#*++@@@                                                 .@@++++++++++@       :     .@##=%=.            .@%                                @@. 
                                                               @@++++++++@   -           =@=*             @@@.                                  @
                                                                  @@++++#@-                :@             @+++@@.                                
                                                        .%=      :   @@.                @@*+@            .@++++++@@                              
                                                         ==+=%@=#=@@                 @@+++++@               #@@@.                                
                                                         @==#==@@                .@@++++++*@@              @@                                    
                                                         #==@@                :@%++++++%@-              @@                                       
                                                         @@                %@*++++++@@.              @@                  @@*+@@                  
                                                        =%#@.               .@@++@@  +#      .   .@@                  @@+++@++++@@-              
                                                        .@+++%@.               .@@@==*====@=%@+@*                 .@@+++++@@%+++++++@@           
                                                         @++++++@@                .@#=*=#==%@-                 +@#++++*@@     @@+++++++@@.       
                                                         .@@+++++++@@                :@+@@.                 @@+++++#@+           %@*++++++*@@    
                                                             @@+++++++@@                                 @@+++++%@:                 .@@+++++++@@.
                                                                @@*++++++@@                          .@@+++++@@.                        @@*++++++
                                                                   :@@++++++@@                    +@#+++++@@.                              -@@+++
              @@@                                                      @@+++@@                 @@++++++@@                                      @@
             @%=#=                 +@#===@                              :@#                 @@++++++@@                                           
           @=%=@=+==.             %===#%%@=                          %@:                .@@+++++*@@                                              
         @#%@@   +@*==@  @-    -@*%==@=+==+@                      @@.                =@#+++++*@*                                                 
       @=@@.        .@@=##*#  %==%==@@.:@@=%@@-.               @@                 @@*+++++#@-                                                    
     @@@                @@==#@===@@        @@=+==@@@   @ @=@@@                 @@++++++@@.                                                       
   @@.                     @@@@:              @@==%===*==@@                 @@++++++@@                                                           
@@.                                              :@@=#@-                -@%++++++@@                                                              
                                                                     @@*++++++@@                                                                 
+@@                                                               @@+++++++@@                                                                    
.                                                             .@@++++++*@%                                                                       
                                                             :@#++++#@+                                                                          
                                                                -@@.                                                                             
                                                                   +@:                                                                           
                                                                      *@.                                                                        
                                                                         %@.                                                                     
                                                                            %@.                                                                  
                                                                            @@@                                                                  
                                                                        .@@+++@                                                                  
                                                                      @@++++++@.                                                                 
@@                                                                       @@@@                                                                    
+++#@*                                                                      @@                                                                   
