                 @@++++++@@  .@%+++++++@            @                                                                                            
@                   @@*+++++@++++++@@+++@            @.                                                                                          
  @@.                  .@@++@++*@@  @++++@.           @*                                                                                         
     %@:                   @@@      @+++++@%           -@                                                                                        
        =@=                         @++++++*@            @                                                                                       
           .@@                      @++++++++@            @                                                                                      
          .@@@:                     @+++++++++@            @.                                              #===@                                 
       =@%+++*%                     @++++++++++@=           @%                                           @=@==@=.                                
    @@*++++++@@                     @+++++++++++#@           :@                                          @+==@=+-                                
 @@+++++++@@                        @+++++++++++++@            @                                        @=+@@@@=+%.                              
++++++*@#                           @++++++++++++++@            @                                      =@@      @@==@+                           
+++%@:                              @+++++++++++++++@.           @.                                  @@            @@#.                          
@@.                                 .@@++++++++++++++@@           @@                              #@.                 @@.                        
                                        @@+++++++++++++@           .@       :                  -@:                       #@.                     
                                           @@+++++++++++@        ..   @@==+#=@              .@+                             *@:                  
                                              @@+++++++++@.    :        .@@==@            .@+                                  +@:               
                                                 %@*++++++@+-              :@@            %*+*@+                                  =@-            
                                           -        -@#@@.                *@#@            @+++++*@*                                  :@+         
                                         @*@=@. @=@@@@.                @@++++@             #@#++@@.                                     .@*      
                                         @==+=+==@@                 @@++++++*@               @@                                            .@%   
                                         @=@==@@                .@@++++++#@=              @@                                                  .@%
                                         @=@@                #@#++++++@@.              @@                  @@@                                   
                                         @@%                @@+++++@@               @@                  @@++@++%@=                               
                                         @++*@*                @@@ .@@==@@@.@#%@@@%                 .@@+++++*++++++@@                            
                                         @+++++*@=                @@=%==%=@==*@=                 -@%++++*@%  @@+++++++@@:                        
                                         @@+++++++#@:                @@=@=%@.                 @@*++++*@+        @@#++++++*@@                     
                                            @@+++++++%@.               .@.                 @@+++++%@:              .@@+++++++@@.                 
                                               +@#++++++%@.                            .@@+++++@@.                     @@*++++++#@@              
                                                  .@@++++++@@                       -@%+++++@@                            :@@+++++++@@           
.                                                     @@++++++@:                 @@*+++++@@                                   @@+++++++%@*       
@=@                   -@@@                               @@@#                 @@++++++@@                                         +@%+++++++@@    
@==@.              @=%===*                             *@-                 @@++++++@@                                                @@+++++++@@-
*@%=+@.           @%#++#====                        @@.                :@%+++++*@#                                                      %@*++++++
    @@#@@==@   -*=====@@@=%=@                    @@                 @@*+++++#@-                                                            .@@+++
       @@==@*@*=%==@@     @@=+%==-           .@@                 @@++++++%@.                                                                   @@
          *@+==#@*           #@+=%@==@@=#+=@@                 @@++++++@@                                                                         
             .                  .@@=+#=*@=                :@@++++++@@                                                                            
                                    @@.                %@*++++++@@                                                                               
                                                    @@+++++++@@                                                                                  
                                                 @@++++++*@@                                                                                     
                                              @@++++++*@*                                                                                        
                                               .@@+%@:                                                                                           
                                                  .@#                                                                                            
                                                     .@%                                                                                         
