                                                                              .        @@*#@=                :@@@            @+++++%@:           
                                                                            @*@.@. @=@@@@.                @@*+++@             @@*++%@:           
                                                                            @==%==+=@@                 @@+++++++@               @@.              
                                                                            @=%==@@                .@@++++++*@@              @@                  
                                                                            @=@@                :@@++++++#@=              @@                  #@@
                                                                            @@-                @@+++++@@.              @@                  @@++@+
                                                                            @++#@:               .@@@  @@=+@@@.@@%@@@@                  @@+++++*+
                                                                            @+++++%@.               .@@=@==@=@*==@%                 .@@+++++@@ .@
                                                                            @@+++++++@@                .@#=@=+@+                 +@#+++++@@      
                                                                               @@+++++++@@                :@:                 @@+++++*@#         
                                                                                  @@*++++++@@                              @@+++++#@-            
                                                                                     -@%++++++@@                       .@@+++++@@.               
                                                                                        .@@++++++@:                 =@#+++++@@                   
                                 *=@=@                   .@@-                               @@@@                 @@*+++++@@                      
                               .#=*@=+@.              @=+====                             :@%                 @@++++++@@                         
                              @*=@@@@==#@            @%=#*+=*==                        *@-                .@@++++++@@                            
                           +@=#@.     :@@@@@==@   :====*=@@*=+=@                    @@.                -@#+++++*@@                               
                          @%@.            @@==#%@@=@==@@.   .@@=%%=+.            @@                 @@*+++++#@+                                  
 @@                     *@.                  @@====@@           @@==+%=+@@=@#=@@                 @@++++++%@:                                     
    @@.              *@.                        =.                 =@#=%#==@@                 @@++++++@@.                                        
       =@+        #@.                                                 .@@=                -@%++++++@@.                                           
          .@@    .@@@                                                                  @@*++++++@@                                               
              @@ @+*@@                                                              @@+++++++@@                                                  
                 @                                                               @@++++++*@@                                                     
+@@                                                                               :@#+*@*                                                        
++++@@:                                                                              :@-                                                         
@++++++#@                                                                               =@:                                                      
  @@*@+                                                                                    =@:                                                   
   .@@%                                                                                       #@.                                                
    @+++@@                                                                                       @@                                              
    @++++++@@.                                                                                @@++@                                              
    %@*+++++++*@@                                                                         .@@+++++@                                              
       .@@++++++++@@                                                                       @@+++@@                                               
           @@++++++++@@-                                                                      @@                                                 
              %@*+++++++*@@                                                                      @@                                              
                 .@@++++++++@@                                                                     .@=                                           
                     @@++++++++%@=                                                                   =@+                                         
                        #@*++++++++@@                                                             +@*++@                                         
                           .@@++++++++@@.                                                      *@*+++++@                                         
                               @@++++++++#@#                                                %@*++++++@@.                                         
                                  *@#++++++++@@                                @@@%      @@+++++++@@                                             
                                     .@@++++++++@@.                         @@++@+++@@@@++++++#@#                                                
                                         @@++++++++*@@                  .@@+++++@+++++*++++@@.                                                   
                                            +@#++++++++@@            *@*++++++%@%@@+++*+@@                                                       
