              .@@                          .@+++++*@            @                                                                                
                  @@                       .@+++++++@            @                                                                               
                   *@@                     .@++++++++@.           @.                                               @#@%                          
                @@+++@                     .@+++++++++@=           @%                                            @=+#+=@                         
             @@++++++@                     .@++++++++++#@           :@                                          +===#=@@                         
         .@@++++++#@=                      .@++++++++++++@            @                                         @==*@++==:                       
      -@%++++++@@.                         .@+++++++++++++@            @                                      =%=@*   -@#%%@                     
   @@*++++++@@                              @++++++++++++++@.           @.                                    @@         :@#@                    
@@+++++++@@                                 @+++++++++++++++@@           %@                                @@               .@*                  
+++++*@@                                      @@++++++++++++++@           .@                            @@                     .@@               
++#@=                                            @@*+++++++++++@          # =@@@@@=@=-               @@                           .@@            
@.                                                  +@#+++++++++@      +       @@=*=+:            #@.                                .@@         
                                                       .@@+++++++@% -             @@=.            @+@@                                   @@      
                                                           @@+++@@                 @@             @++++@@                                   @@   
                                                .==: .  *@. .@@                 @@++@             @@+++++@@                                    @@
                                                 ==%=#=#==@@                .@@+++++@                @@@                                         
                                                 ===*=+@+                *@*++++++@@.             .@@                                            
                                                 *=%@:                @@+++++++@@              -@+                  .                            
                                                .@.                @@++++++*@@              *@:                 .@@*+#@@                         
                                                .@+@@                @@+#@+  @@. *   @   @@.                 +@#+++@+++++@@                      
                                                 @++++@@                @@+%==%==@=+=@@@.                 @@*++++@@@@+++++++%@+                  
                                                 @+++++++@@                @@==@*==@@                  @@+++++@@.     -@@+++++++@@               
                                                  +@#+++++++@@                @@@@                 .@@+++++@@             @@+++++++@@:           
                                                     .@@+++++++@@                               =@#+++++@@                   #@#+++++++@@        
                                                         @@++++++*@+                         @@*+++++@@                          @@+++++++@@.    
                                                            @@++++++*@=                   @@+++++*@@                                @@*++++++*@@ 
      @=+@                     -                               *@#+@@.                .@@+++++*@+                                      :@@+++++++
    .@*==*.                @@=*@=@                              @@                 -@%+++++%@:                                             @@++++
   @++=@@=%=.             @==#==@=@+                         @@                 @@*+++++@@.                                                   +@%
.@==@@    @@==% ++@    @=*==*===@==@                     .@@                 @@++++++@@                                                          
=@@          @@+=@+@+ @+=+=@@@  @@===@@@:             -@*                 @@++++++@@                                                             
                :@@==@==@@.        -@@=@===@. *@=@@@@:                -@%++++++@@                                                                
                    @@@                @@=====@#@@.                @@*++++++@@                                                                   
                                          @@=@@                 @@++++++*@@                                                                      
                                                            .@@++++++#@=                                                                         
                                                         :@%++++++@@.                                                                            
                                                      %@*++++++@@.                                                                               
                                                      @@++++@@                                                                                   
                                                         @@                                                                                      
                                                            @@                                                                                   
                                                               @@                                                                                
                                                                  @@                                                                             
                                                                     @@                                                                          
                                                                   :@@@                                                                          
