                     @@                       @+++++++#@           .@                                                                            
                     @@@                      @+++++++++@            @                                               +==@@                       
                  @@+++%:                     @++++++++++@            @                                            -==@#@#                       
               @@++++++*@                     @+++++++++++@.           @:                                          @*====%                       
           :@@++++++%@:                       @++++++++++++%@           #@                                        @=**@@+=+@                     
        #@*++++++@@.                          @+++++++++++++*@           .@                                      *=@-    -@*==@                  
     @@+++++++@@                              @+++++++++++++++@            @                                   .@#          :@*@                 
  @@+++++++@@                                 @@+++++++++++++++@.           @                                @@                .@*               
+*+++++*@*                                       @@+++++++++++++@*           @=                           @@                      .@@            
+*++@@:                                             @@*++++++++++*@         @  *@*@=@@@@               @@                            .@@         
@@@                                                    +@#+++++++++@     #        @@=*=@            .@                                  .@@      
                                                          .@@+++++++@ +              @@@            @++@@                                   @@   
                                                              @@++@@                 @@@            @+++++@@                                   @@
                                                   @=@ %  @@@:.@@                .@@+++@            :@@++++@@                                    
                                                   @==*==@=+@*                =@#++++++@               .@%                                       
                                                   @====#@:                @@*++++++@@              -@+                                          
                                                   @=@@.                @@+++++++@@              #@:                 .@.                         
                                                   @@                 @*+++++*@#              @@.                 -@%+@+*@@                      
                                                   @++@@                @@%@: =#=@=@@ :@-++@@                  @@*++++*+++++@@                   
                                                   @+++++@@                @@=*==+@+#%==@@                  @@+++++@@.@@*++++++#@%               
                                                   @*+++++++@@                @@==%==@@                  @@+++++@@       :@@+++++++@@            
                                                     =@#+++++++@@                @@@                 :@@+++++@@              @@+++++++@@=        
                                                        .@@+++++++@%                              @@*+++++@@                    *@%+++++++@@     
                                                            @@++++++*@+                        @@+++++*@@                           @@+++++++@@: 
                                                               @@++++++*@.                 .@@+++++*@*                                 @@*++++++*
        @=#*@                    @@                               +@#@@                 :@@+++++%@:                                       .@@++++
       @==#=@=               @==@+@+                              @@                 #@*+++++@@.                                              @@+
     =%==@@@=+@:            @+=@@+=*=@                        .@@                 @@++++++@@.                                                    
  .@==@@     @@=@*@@=+   -=@==%=*@=%===                    :@#                 @@++++++@@                                                        
 @=@@           %@+=%=@@@=+==*@*   @@#=+%@@             *@-                .@@++++++@@                                                           
@@                 .@@====@@.         :@@=%=@=@-@@@@=@@.                #@*++++++@@                                                              
                       @@                 @@==++@=@@                 @@++++++*@#                                                                 
                                             @@@@                 @@++++++#@=                                                                    
                                                              .@@++++++@@.                                                                       
                                                           +@#++++++@@.                                                                          
                                                        @@*++++++@@                                                                              
                                                         @@+++@@                                                                                 
                                                            @@                                                                                   
                                                               @@                                                                                
                                                                  @@                                                                             
                                                                     @@                                                                          
                                                                        @@                                                                       
                                                                     *@#+@                                                                       
                                                                  @@+++++@                                                                       
