                                                                                         @++*@*                @@+ @@@==@=@@@=*@@@               
                                                                                         @+++++*@=                @@@#====%*=@@                  
                                                                                         @@+++++++#@:                @@===@@                 .@@+
                                                                                            @@*++++++#@.               .%                 *@*++++
                                                                                               =@#++++++@@.                            @@+++++*@@
                                                                                                  .@@++++++@@                       @@+++++*@+   
                                                +                                                     @@+++++@@                 .@@+++++%@:      
.                                             @===@                  .@*@@                               @@@                 *@#+++++@@.         
 %@:                                        @===*==@:             %=+==%+@                             @@                 @@++++++@@             
    :@#                                   :@==@#:@%==@-  .       :+=+=*%===@                       .@@                 @@++++++@@                
       .@@                              @*=@*      .@@+%+==%   @+*=#==@@@=@=@                   *@-                .@@++++++@@                   
           @@                         +*@*             @@=%%=*=@+=@@.     @@====@=           @@.                =@#++++++@@                      
              @@.                   .@#                   *@*==@@            %@*=%===@+=%=@@                 @@*+++++*@@                         
:                =@+             .@*                                            .@@==#=@@                 @@++++++#@=                            
+*@*                .@@       .@#                                                   @@                .@@++++++%@.                               
+++++@@                 @@    @+@@.                                                                =@%++++++@@.                                  
@+++++++@@                 @@.@*@@                                                              @@*++++++@@                                      
  @@*++++++@@                 .                                                              +@+++++++@@                                         
     =@#++++++%@:                                                                              .@@+@@                                            
        .@@++++++*@#                                                                              .@@                                            
            @@++++++@*                                                                               .@#                                         
               @@@@                                                                                     .@*                                      
                @+@@                                                                                       :@=                                   
                %*+++@@.                                                                                     :@-                                 
                =#++++++#@#                                                                               @@*+*%                                 
                 -@%++++++++@@                                                                         @@++++++@                                 
                     @@++++++++@@.                                                                      @@++@@.                                  
                        @@*+++++++*@@                                                                      @@                                    
                           :@@++++++++@@                                                                      @@                                 
                               @@++++++++@@:                                                                    .@@                              
                                  @@*+++++++*@@                                                                  .@@                             
                                     :@@++++++++@@                                                            .@@++@.                            
                                         @@++++++++%@-                                                     .@%+++++#+                            
                                            @@*++++++++@@                                               :@#++++++@@:                             
                                               .@@++++++++@@.                              #@@@@     -@#++++++@@                                 
                                                   @@++++++++#@+                        @@+++@+++%@@#+++++*@@                                    
                                                      %@#++++++++@@                  @@++++++%++++*++++%@-                                       
                                                         .@@++++++++@@.          :@@++++++*@%.@@*+#+@@.                                          
                                                             @@++++++++#@#    %@*++++++%@-        *                                              
                                                                #@#++++++++@@+++++++@@.                                                          
                                                                   .@@+++++*+++++@@                                                              
                                                                       @@++#++@@                                                                 
                                                                          +@#                                                                    
                                                                                                                                                 
