                                                                                       +#%@.               .@%++@@  *+      .   .@@              
                                                                                       :%+++@@.               .@@@==#====@=%@+@*                 
                                                                                       .@++++++@@                :@+=#=#==@@-                 +@#
                                                                                        .@@+++++++@@                -@=@@.                 @@++++
                                                                                            @@+++++++@@                                 @@+++++%@
                                                                                               @@*++++++@@                          .@@+++++@@.  
                                                                                                  -@%++++++@@                    +@#+++++@@.     
                                             @@@                                                     .@@+++@@                 @@++++++@@         
                                            @@=#=                 =@#===@                              -@#                 @@++++++@@            
 @@                                       @=%=@=*==              %===%@#@-                          @@:                .@@+++++*@@               
    @@:                                 @#@@@   #@+==%  @:    -@*%==@=*==+@                      @@.                =@#+++++*@*                  
       :@#                            @=@@.        .@@=%#*+  %==%==@@.-@%=#@@:                @@                 @@*+++++%@-                     
           @@                       @@@                @@==#%===@@        @@=*==@@@   % @=@@@                 @@++++++@@.                        
              @@                  @@                      @@@@:              @@==#===+==@%                .@@++++++@@                            
.                @@.           @@.                                              -@%=#@-                -@%++++++@@                               
+%@.                =@=      @@                                                                     @@*++++++@@                                  
++++*@+                .@@   @++@@                                                               @@+++++++@@                                     
@+++++++@@                 @@@@.                                                             .@@++++++*@%                                        
  @@+++++++@@                                                                               =@*++++#@+                                           
     @@*++++++@@                                                                               +@@.                                              
        =@%++++++@@.                                                                              #@.                                            
           .@@+++#@.                                                                                 %@.                                         
               @-                                                                                       @@                                       
               @+*@@                                                                                       @@                                    
               @+++++@@                                                                                    @@@                                   
               @++++++++@@:                                                                            .@@+++@                                   
                 #@*+++++++*@@                                                                       @@++++++@.                                  
                    .@@++++++++@@                                                                       @@@@                                     
                        @@++++++++@@=                                                                     .@%                                    
                           *@#++++++++@@                                                                     :@-                                 
                              .@@++++++++@@                                                                     +@.                              
                                  @@++++++++#@*                                                                @@+@                              
                                     +@#++++++++@@                                                          @@++++@                              
                                        .@@++++++++@@.                                                   @@+++++++@                              
                                            @@++++++++#@@                                             @@+++++++@@                                
                                               =@%++++++++@@                             @@++*@@   @@++++++#@#                                   
                                                  .@@++++++++@@.                     .@@+++*+++++@++++++@@.                                      
                                                      @@*+++++++*@@               #@*++++++%+++++@+++@@                                          
                                                         -@%++++++++@@         @@+++++++@@    @@#@@@                                             
                                                             @@++++++++@@-  @@+++++++@@                                                          
                                                                @@*+++++++@++++++*@@                                                             
                                                                   :@%++++@+++#@+                                                                
                                                                      .@@+@@@.                                                                   
                                                                                                                                                 
