++++++++++++++++++++++++@@.                                     :@%+++++++++++++@.           @                             @#                    
+++++++++++++++++++++@@                                            .@@+++++++++++%@          : @@@@#@==@                @@                       
  .-#@@@@@@@@@@@@#@@                                                   @@++++++++++@      *       @#*=#@             @@                          
                                                                          @@++++++++@  @            -@=@            =#%@.                        
                                                                             @@*++*@#                .@@            @++++%@:                     
                                                                   @*@    .@@  +@-                =@#++@            @@+++++#@.                   
                                                                   @===*+=#=@@.                @@*+++++@               =@@:                      
                                                                   @==+==@@                 @@+++++++@@              @@.                         
                                                                   @==@@                .@@++++++*@#              @@                  .          
                                                                   @@                 @%++++++@@:              @@                  @@*@+@@       
                                                                   @+#@:                @@+@@   @@ .@  :*   @@                  @@++++#++++#@*   
                                                                   @++++#@.               .@%*+=**#=@=@=@@@                  @@+++++@@@@+++++++@@
                                                                   @+++++++%@.               .@%==%===@%                 :@%+++++@@      @@++++++
                                                                     @@+++++++@@                :@@@=                 @@*++++*@@            +@#++
                                                                        @@+++++++@@                                @@+++++*@*                   @
                                                                           *@#++++++@@                          @@+++++%@:                       
                                                                              .@@++++++@@                   :@@+++++@@.                          
                        -@@@.                                                     @@++@@                 %@*+++++@@                              
                       @@=@=@                :@+#@==                              .@@                 @@++++++@@                                 
                      @@=*@==*@             @#=%%=#=@@                         -@+                 @@++++++@@                                    
                   @%=#@:   -@%=#  @@.    @=%==@*===*=+                     @@.                .@@++++++@@                                       
                 @=*@:         .@@=+=@@.=@=#==@@: .@@=@*@@@              @@.                *@*+++++*@#                                          
                @@:                @@==+==-@@         @@====+#@  @=@@@@@                 @@++++++#@=                                             
             +@:                      #@@+               #@+=@=@=*=@@                 @@++++++@@.                                                
          =@:                                               .@@*@#                .@@++++++@@                                                    
.@%      @@                                                                    *@#++++++@@                                                       
    @@  ##++@#                                                              @@+++++++@@                                                          
       @@@-                                                              @@+++++++@@                                                             
                                                                        .@%++++@@                                                                
                                                                           :@%                                                                   
                                                                              -@-                                                                
                                                                                 +@:                                                             
                                                                                    +@.                                                          
                                                                                       %@.                                                       
+@@.                                                                                  @@*@                                                       
++++#@*                                                                            @@++++@                                                       
++++++++@@                                                                       @@+++++@@                                                       
 @@++++++++@@.                                                                      @@@                                                          
    @@*+++++++*@@                                                                      @@                                                        
       :@@++++++++@@                                                                     .@#                                                     
           @@++++++++@@:                                                                    -@.                                                  
              @@*+++++++*@@                                                               =@#+@                                                  
                 :@@++++++++@@                                                         +@*++++@                                                  
                     @@++++++++%@-                                                  *@*++++++@@                                                  
