                 @@+++++++@@                               @+++++++++++++++@-           @:                                  @@            -@*.   
+**#@@@@@@@@@@@@+++++++@@                                   @@++++++++++++++#@           *@                              @@                  :@= 
++++++++++++++*++++*@@                                         @@+++++++++++++@           .@.     -@-                 @@                        .
@%**++++++++++*+%@-                                               @@*++++++++++@        *    @@=+===@              @@                            
            .-@.                                                     +@#++++++++@.   =          @@=*@            -@@                             
                                                                        :@@++++++@-               .@@            @+++@@                          
                                                                 *@         @@@@                 @@+@            @++++++@@                       
                                                                @*#@@.=#=@@@@                 @@++++@             .@@++@@                        
                                                                @=@==@==@#                -@%++++++@@              .@@                           
                                                                @===*@=                @@*++++++@@              :@#                              
                                                                @%@.                @@+++++++@@              +@-                  @@@.           
                                                                @@@                @@++++*@%              @@.                 :@%++%++*@@        
                                                                @+++@@                @@%.*@@==@=@@@==@@@.                 #@*++++#+++++++@@.    
                                                                @++++++@@                @@====@=@==@@                  @@+++++@@.  @@*++++++#@% 
                                                                @@*+++++++@@                @@=%=@@                  @@+++++@@         .@@+++++++
                                                                   =@#++++++*@*                @                 :@@+++++@@                @@++++
                                                                      .@@++++++*@+                            %@*+++++@@                      =@@
                                                                          @@++++++#@-                      @@++++++@@                            
                       #                                                     @@+++++%@                  @@+++++*@%                               
                     @=%=@                  .@*#@                               +@@.                .@@+++++#@=                                  
                   @+=+#+=@#             .==*===@                             @@                 *@#+++++%@.                                     
                 .@==@@.@@==@#           @*#=#%==*=                        @@                 @@++++++@@.                                        
               @==@@       @@=%#==@   ##==@==@@@=#=@                   .@%                 @@++++++@@                                            
             .@@@             #@+++===#@=#@+     @@==*==@           +@=                .@@++++++@@                                               
            @@                   .@@==@@.           .@@=%#==@#=#=@@.                *@#++++++@@                                                  
         @@                                             @@==@=@@                 @@++++++*@@                                                     
      @@                                                   @@                 @@++++++*@*                                                        
@.   =%#@*                                                                .@@++++++%@:                                                           
  *@-@+@@                                                              =@#++++++@@.                                                              
     .                                                               @*++++++@@.                                                                 
                                                                       @@+@@                                                                     
                                                                          @@                                                                     
                                                                             @@                                                                  
                                                                                @@                                                               
                                                                                   @@                                                            
                                                                                    .@@                                                          
@@                                                                               #@#++@                                                          
+++@@                                                                         @@++++++@                                                          
++++++#@*                                                                      -@*+@@=                                                           
@#++++++++@@                                                                      #@                                                             
  .@@++++++++@@.                                                                     @@                                                          
      @@*+++++++#@@                                                                     @@                                                       
         =@%++++++++@@                                                                   @@=                                                     
            .@@++++++++@@.                                                            @@++*@                                                     
