                   @@++++++@@@@+++++++++@            @                                                                                           
 @@                   @@*++++@++++*@@@+++@            @-                                                                                         
    @@                   .@@+@+@@.   @++++@=           +@                                                                                        
       @@                    -       @+++++#@            @                                                                                       
          @@.                        @+++++++@            @                                                                                      
             *@                      @++++++++@            @                                                 @@                                  
          @@*+@                      @+++++++++@.           @=                                             @%+==@                                
       @@+++++@                      @++++++++++%@           =@                                           @==++=@                                
    @@++++++*@#                      @++++++++++++@            @                                         .+==#=%=@*                              
.@@++++++%@-                         @+++++++++++++@            @                                       @@=@*  @@*=@.                            
++++++@@.                            @++++++++++++++@.           @                                     @@@        @@==.                          
+++@@                                @+++++++++++++++@#           @+                                 @@              @@                          
@@                                    =@#+++++++++++++*@           -@                             @@                    @@                       
                                         .@@++++++++++++@            @@ .@% @@@                @@                          @@                    
                                             @@++++++++++@       =      @##=#=@             #@.                               @@                 
                                                @@++++++++@-  -           -@=*@            @@@.                                  @@.             
                                                   @@+++++@@                 @@            @+++%@.                                  @@.          
                                          @@+         #@@                 @@+*#            @++++++%@                                   %@.       
                                          @=*%=@@*=*@@                .@@++++#=              @@#@@                                        #@.    
                                          @#==%=+@%                -@%++++++@@              .@@                                              +@: 
                                          @==*@=                @@*++++++@@              .@%                                                    =
                                          @@.                @@+++++++@@              =@=                  @@%@@                                 
                                          @#@.                @@++*@%  =           @@.                 :@%+++++++@@:                             
                                          @+++%@.               .@@@@=%==+=@#=+@@@.                 %@*++++#@#++++++*@@                          
                                          @++++++@@.               .@%=#==%==@@                  @@+++++@@.   .@@+++++++@@.                      
                                           @@+++++++@@                :@+=@@                  @@+++++@@           @@*++++++*@@                   
                                              @@+++++++@@                                 :@@+++++@@                 .@@+++++++@@                
                                                 %@*++++++@@                           %@*+++++@@                        @@+++++++#@%            
                                                    -@%++++++@@                     @@++++++@@                              -@@+++++++@@         
@@                                                     .@@+++%@:                 @@+++++*@@                                     @@+++++++@@=     
+@=@                 +@+*=@                               @@.                .@@+++++#@+                                           #@#+++++++@@  
==*==@             @#===@=@.                           @@                 *@#+++++%@:                                                 .@@+++++++@
  #@*==@  @.     @@=+@=*%==++                       @@                 @@++++++@@.                                                        @@*++++
     .@@=%@=*   @=+%@=@@-@@=#@@.                .@%                 @@++++++@@                                                               :@@+
         @@*=%=%=%#@=       @@=*==@@%   . -+.=@=                .@@++++++@@                                                                      
            @@=@@              @@==#==*=#=@@.                *@#++++++@@                                                                         
                                  :@@==@@                 @@++++++*@@                                                                            
                                                       @@++++++*@*                                                                               
                                                   .@@++++++%@-                                                                                  
                                                =@#++++++@@.                                                                                     
                                              .@#+++++@@.                                                                                        
                                                 -@@@                                                                                            
                                                    =@:                                                                                          
                                                       *@.                                                                                       
