                                                                                      @-                @@+++++++@@              :@*             
                                                                                      @+@@                -@**@@  +@= -.  @   +@-                
                                                                                      @++++@@                *@=#==*==#===+%@.                 #@
                                                                                      @+++++++@@                #@==*%==@@                  @@+++
                                                                                       :@%+++++++@@                @@@@                  @@+++++@
                                                                                          .@@+++++++@@                               .@@+++++@@  
                                                                                              @@+++++++@@                         +@#+++++@@     
                                                                                                 @@*++++++@%                   @@++++++@@        
                                           @==@                     :                               :@@+#@=                 @@++++++@@           
                                          @===+#                @@==@=@                              @@.                .@@+++++*@#              
@@                                      #===@@=*=+             @==+=#%=@@                         @@                 +@#+++++#@-                 
   @@.                                @==@@    @@==@ :@@    %+===@+=+#==%                      @@                 @@++++++@@.                    
      #@-                           @=@@          =@*=%=@% @@=#=*@@  %@+++@@@*             .@@                 @@++++++@@                        
         .@%                      .@@                .@@==%==@@+        .@@=%==+@= :@:@@@@#                .@@++++++@@                           
             @@                 @@                       @@@                @@==+==#%%@:                =@#++++++@@                              
                @@           @@                                                #@*@@                 @@*++++++@@                                 
@@.                %@.     @@%                                                                    @@++++++*@%                                    
+++%@:                -@*  @++#@                                                              .@@++++++*@+                                       
++++++*@*                .@@@                                                              -@%++++++%@:                                          
.@@+++++++@@                                                                               @@++++@@.                                             
    @@+++++++@@                                                                               @@                                                 
       @@*++++++@@                                                                               @@                                              
          :@@++@@                                                                                   @@                                           
             @@.                                                                                       @@                                        
             @++#@*                                                                                       @@                                     
             @*+++++@@                                                                                  .@@@:                                    
             *@++++++++@@.                                                                           *@#+++*#                                    
                @@*+++++++#@%                                                                       @@++++*@@                                    
                   -@@++++++++@@                                                                      .@@:                                       
                       @@++++++++@@.                                                                     -@:                                     
                          @@*+++++++*@@                                                                     #@.                                  
                             :@@++++++++@@                                                                     @@                                
                                 @@++++++++@@:                                                               @@+@                                
                                    @@*+++++++*@@                                                         @@++++@.                               
                                       :@@++++++++@@                                                   @@+++++++@-                               
                                           @@++++++++@@=                                  @         @@++++++*@@                                  
                                              %@*++++++++@@                           :@@+@+#@@  @@++++++@@.                                     
                                                 .@@++++++++@@.                    *@*++++@++++#++++++@@                                         
                                                     @@++++++++#@#              @@+++++++@@++++%++*@%                                            
                                                        #@*++++++++@@        @@+++++++@@     @@@@:                                               
                                                           .@@++++++++@@..@@++++++*@@                                                            
                                                               @@+++++++*++++++#@=                                                               
                                                                  *@#+++%+++@@.                                                                  
                                                                     .@@@@@                                                                      
