                                                                                          @*++++@@                :@*=*@=@*=*==@@                
                                                                                          *@+++++++@@                -@+#===@@                  @
                                                                                             @@+++++++@@                +@@                 .@@++
                                                                                                @@+++++++@@                              -@%+++++
@                                                                                                  %@*++++++@@                        %@*+++++@@ 
@                                                                                                     :@@++++++@@                  @@++++++@@    
@.                                             .===@                    %@.                               @@%@:                 @@+++++*@%       
  @@                                          @=#@=@@               @==%=+=-                             @@.                :@@+++++#@+          
     @@.                                     %=@@@@==@@            =*=%===%=*.                        @@                 @@*+++++%@:             
        *@-                               @==@@     +@*+@@@=@    ##==+=+@==*=@                     @@                 @@++++++@@.                
           .@@                          @=@@           .@@==+#@@==+==@@   .@@=@=#@.            .@%                 @@++++++@@                    
               @@                      @@                  @@====@@:          @@=%===#@*@@@=#@-                :@@++++++@@                       
@                 @@.               @@                        @@                 @@+=@*#=@@.                #@*++++++@@                          
++@@.                %@.         @@                                                 .@@@                 @@++++++*@@                             
+++++%@-                :@*     @@@                                                                   @@++++++*@*                                
@@++++++*@#                .@@ :@+@@-                                                             .@@++++++#@-                                   
   @@+++++++@@                 @@                                                              *@#++++++@@.                                      
      @@+++++++@@                                                                               =@*++@@                                          
         %@*++++++@@.                                                                              #@.                                           
            :@@++++++%@                                                                               #@.                                        
                @@+@@                                                                                    @@                                      
                  @@-                                                                                       @@                                   
                  @++*@@                                                                                       @@                                
                  @++++++@@.                                                                                :@@+@                                
                  @@++++++++%@+                                                                          @@*++++@                                
                     =@#++++++++@@                                                                       @@+++*@@                                
                        .@@++++++++@@.                                                                      @@                                   
                            @@*+++++++#@%                                                                     .@*                                
                               -@%++++++++@@                                                                     -@:                             
                                  .@@++++++++@@.                                                                    @@                           
                                      @@*+++++++*@@                                                              @@++@                           
                                         -@%++++++++@@                                                        @@+++++@                           
                                             @@++++++++@@:                                                 @@+++++++@@                           
                                                @@*+++++++*@@                                .@@:       @@++++++#@=                              
                                                   :@@++++++++@@.                         =@%+*+++@@.@@++++++@@.                                 
                                                       @@++++++++%@=                   @@*++++%+++++@+++++@@                                     
                                                          @@*++++++++@@             @@+++++++@@@%+++@+#@+                                        
                                                             .@@++++++++@@.     .@@+++++++@@      +@@.                                           
                                                                 @@++++++++#@#@#++++++*@#                                                        
                                                                    @@*++++++@+++++%@:                                                           
                                                                       .@@+++@++@@.                                                              
                                                                           @@@@                                                                  
                                                                                                                                                 
                                                                                                                                                 
