                                                                                  @######@######==+%=@                                           
%:                                                                                @######%######@@@=+*                                           
==@                                                                               @##############.  #@=.                                         
@=@                                                                               @##############      -@+                                       
=@==@                                                                             @#####@########         .@@                                    
 @@++=:                                                                           @%####@#######%             @@                                 
    @@.                                                                          @   %@#@#######@                @@                              
       *@-                                                                     -@       +@######@                   @@                           
          :@#                                                                 @.           -@###@                      @@.                       
             .@@                                                             @                :@@                         *@:                    
                 @@                    @####@                              @@                 .@@@@                          :@*                 
                    @@               @########@                           @.                 @#+@+++@@                          .@@              
                       %@.         .###########-                        .@                 .@+++@*+++++@@                           @@           
@                         =@-     .############@                       @*                 @%++++@ :@%+++++@@     -**                   @@        
@+                           .@%  @############@                      @                  @++++++@    .@@+++++@@#####@#@                   @@.    
                                 @#############@                    :@                 @@+++++++@        @@++#######@###@                    #@. 
                                 @#######%#####@ +*+%              @:                 @+++++++++@           @@######@####@                      =
                                 @#######@#####@%**@+@            @                 @@++++++++++@            @######@#####@                      
             @@@@@               @#######@#####@=@@@@=+         #@                 @++++++++++++@            @######@######@                     
          @@+++@+++@@.           @#######@####@@      -@#      @.                #@+++++++++++++@            @######@######%                     
      .@@++++++@++++++%@-        @#######@#@:            .@@  @                 @+++++++++++++++@        :@@ @######@######%                     
   -@#++++++@@  *@#++++++*@@     @######@.                   @                +@+++++++++++++#@-         @@@:%#############@                     
%@*++++++@@        .@@+++++++@@  @##@@                          -            @++++++++++++#@:           .@+++*@@###########@                    *
++++++@@               @@+++++++@@:                                 -      :@++++++++++#@:              *@+++++++@@########@                 @@++
@*+@@                     @@*#@=                                       @  @*++++*%*%#@:                    @@+++++++@@#####@              @@+++++
  #@:                       %%@-                                          .@@@@==%=@                          %@*++++++*@@#@          =@%+++++++@
     =@- +  @: @.           @*++*@+                                           @@=*=%                             -@%+++++++@@      @@*++++++*@#  
        :@#==+==.           @++++++*@%                                           @@@                                .@@+++++++@@@@+++++++%@:     
           .@@==              @@+++++++@@                                       @@+@                                    @@++++++*+++++@@.        
               @                 #@*++++++@@                                 @@++++@                                       @@+++*++@@            
           .@@+@.                   +@*++++++@@                           @@+++++++@                                          @@@@               
        %@*++++#+                      -@#++++++@@                    .@@+++++++@@.                                                              
     @@++++++*@@                          :@%++++++@@.             =@#+++++++@@                                                                  
  =@++++++@@.                                .@@++++++@@.       %@*++++++*@@                                                                     
   :@+*@@                                        @@++++++#@- @@+++++++%@-                                                                        
     @                                              @@++++++@++++++@@                                                                            
      @                                                @@+++@+++@@                                                                               
       @.                                                 @@@@@                                                                                  
        @#                                                                                                                                       
         :@                                                                                                                                      
           @                                                                                                                                     
            @                                                                                                                                    
@            @.                                                                                                                                  
+@=           @%                                                 #                                                                               
