                                                               -@###@@                                                                           
                                                              @####@###@ #@=@                                                                    
                                                             @#####@#####====@                                                                   
                                                            @######@#####@==*=@                                                                  
                                                            @######%######*##=+.                                                                 
                                                            @#############@ %@=+@.                                                               
                                                            @##############    -@+                                                               
                                                            @#####@########       .@@                                                            
                                                            @#####@#######@           @@                                                         
                                                           .@#@###@#######@              @@                                                      
                                                          @+    =@@#######@                 @@                                                   
                                                         @         :@#####@                    @@.                                               
                                                       -@             .@##@                       *@:                                            
                  :++.                                @:                 +@.                         :@*                                         
                @#%####@                             @                  @+@+@@.                         .@@                                      
@.            @###%#####@                          @@                 -@++%++++@@.                          @@                                   
  +@-        @###########@                        @                  @++++@@%+++++@@.                          @@                                
     .@%    @############@                       @                 :@+++++@  .@@+++++@@. .@###@.                  @@.                            
         @@ #############@                     @#                 @*++++++@      @@+++++@#####@##@                   %@.           =@@           
           @#############@   @                @                 .@++++++++@         @@+@######@###@                     =@=  + .+@@==@           
           @#############@ @%@*             :@                 @*+++++++++@            @######@####%                       .@@=%@====@           
           @#######%#####@+===+@@          @:                 @+++++++++++@            @######@#####%                         .@@==@=@           
           @#######%#####@@@  #@@         @                 @#++++++++++++@            @######@######@                            @@=@           
:          @#######@###@.        .@@    #@                 @++++++++++++++@          .@@######%######@                             @@            
+*@%       @#######@@                @@@                 @@++++++++++++++@@        @:  ##############@                         .@@++@            
+++++@@    @####@@                      *               @+++++++++++++@@          .@+*@@#############@                      #@*+++++@            
@+++++++@@ @#@.                            ..         @@+++++++++++@@             #*+++++@@##########@                   @@+++++++@@             
  @@+++++%@-                                   @     @++++++++++@@                 @@+++++++@@#######@               .@@+++++++@@                
     +@@                                          .%@+++@@@@=@@                       %@*++++++%@%###@            *@#++++++*@@                   
      @+*@+                                           @@*+====                           -@#+++++++@@@         @@+++++++#@=                      
      @++++*@@                                           @@+==                              .@@+++++++@@    @@+++++++@@.                         
      %@+++++++@@                                           @@                                  @@+++++++@%+++++++@@                             
         *@*++++++@@                                     @@++@                                     @@++++++++++@@                                
            =@#++++++@@                              .@@++++*%                                        @@**+*@@                                   
               :@%++++++@@                        =@#+++++++@=                                           +=                                      
                  .@@++++++@@.                 @@*+++++++@@                                                                                      
                     .@@++++++%@.           @@+++++++#@*                                                                                         
                         @@++++++#@-     @@+++++++@@.                                                                                            
                            @@++++++*@@@+++++++@@                                                                                                
                               @@+++++@+++++@@                                                                                                   
                                  @@++@+*@#                                                                                                      
                                     @@:                                                                                                         
                                                                                                                                                 
                                                                                                                                                 
