####@+=#                                                                                 @#############@@@==@                                    
####@%#=%@                                                                               @#####@#######@   %@@                                   
####@#=@=@                                                                               @#####@#######@      -@+                                
##@- @@=@==@                                                                             @#####@#######@         .@%                             
        @@=+%                                                                            @%####%#######@             @@                          
           @@.                                                                         +@   %@#########@                @@                       
              #@-                                                                     @.       *@######@                   @@                    
                 :@#                                                                 @            =@###%                      @@.                
                    .@@                                                            @%                :@=                         +@-             
                        @@                   @%@###@                              @                  @##@@                          :@#          
@@                         @@              -###@#####@                          .@                  @++++++@@                          .@@       
   @@                         @@.         @####@######                         @=                 @%++*@#+++++@@                           @@    
     .@@                         +@-     @#####@######.                       @                  @++++#. :@%+++++@@    :@@@                   @@ 
:@*   @@                            .@@  ######%######.                     =@                 @@+++++@.    .@@+++++@@#####@#@                   
  =@%                                  .@######%######.                    @.                 @+++++++%-        @@++@######@###*                 
@.                                      @#############. @==@              @                 %@++++++++%=           @@######%####@                
                                        @#############@=#=**@           @@                 @++++++++++#+            #######%#####@               
                   -@%@@@               @#############=+@*@@=@         @                 *@+++++++++++*#            ##############.              
                @@*+++@+++@@.           @############@=      -@@     .@                 @+++++++++++++*%           +##############@              
             @@++++++%*++++++#@=        @########%@              @@ @+                =@++++++++++++++*%        @@ .##############@              
          @@++++++@@.  #@#++++++*@@     @#####@:                    .                @++++++++++++++@@         +#@@-######%#######@              
      .@@++++++@@.        .@@+++++++@@  @##@                           -           :@++++++++++++@@            @++++*@@###%#######@              
    @#++++++@@.               @@+++++++@@                                  =      @*++++++++++@@               @@+++++++@@@#######@              
      @@*@@                      @@*@@                                        % .@+++*+@@++@@                     @@+++++++@@#####%             @
         *@:                       @#@:                                          .@@@==%#=                           #@*++++++*@@#+          @@++
            =@= @.=@%-@            @+++*@+                                           @@=%=                              :@%+++++++@@     :@@+++++
               :@@==+=@            @++++++*@@                                           @@                                 .@@+++++++@@@*+++++++@
                  .@@=@              @@+++++++@@                                      :@%%-                                    @@+++++#+++++*@#  
                     @@                 %@*++++++@@                                #@*+++@                                        @@++@++@@:     
                  @@++@                    +@*++++++@@                          @@+++++++@                                           %@@         
               @@+++++@                       -@#++++++@@                    @@+++++++#@+                                                        
           =@%++++++@@.                          .@%++++++@@.             @@+++++++@@.                                                           
        :@*+++++#@%                                 .@@++++++%@.      .@@+++++++@@                                                               
    ..    @@+@@                                        .@@++++++#@=-@#+++++++@@                                                                  
 #         :@                                              @@++++++*+++++*@#                                                                     
@            @                                                @@+++*++@@:                                                                        
+@            @                                                  @@@@                                                                            
++@            @.                                                                                                                                
+++@.           @@                                                                                                                               
++++@@           .@                                                                                                                              
++++++@            @                                                                                                                             
+++++++@            @                                                                                                                            
++++++++@            @.                                                *@                                                                        
+++++++++@*           %@                                             :@@==@                                                                      
