#==.                                                                                  ######@######@@=*=@.                                       
#%+=@-                                                                                ######@#######@ -@*#@                                      
##%==%@                                                                               ######@#######@    .@%                                     
@@=@==@@                                                                              ######@#######@        @@                                  
   @@=+=@@                                                                            ##############@           @@                               
      %@=@                                                                           @ -@###########@              @@                            
         -@*                                                                       .@     :@########-                 @@.                        
            .@@                                                                   @=         .@#####.                    *@-                     
                @@                                                               @              .@##.                       :@#                  
                   @@                      -@@@:                               =@                  @@:                         .@@               
                      @@.                @##@####@                            @.                 @@*++#@:                          @@            
                         *@-           .####@#####@                          @                  @++%+++++#@.                          @@         
 @@                         :@#       :#####@#####%                        @@                 @@+++@ @@+++++#@:                          @@      
    @*                         .@@    %#####@#####%                       @                  @+++++@    @@+++++%@..@####@:                  @@.  
@@@                                @@@######@#####%                     .@                 #@++++++@       @@++++@#########@                   =@
                                     #######@######   @@               @+                 @++++++++@          @@+%##########@                    
                                     #######@###### *@=+@             @                 +@+++++++++@             ############@                   
                  @@                 #######@######@%=@==%@         -@                 @+++++++++++@            .#############@                  
               @@++*+@@:             #######%######@@   :@%        @.                :@++++++++++++@            =######%#######:                 
           :@@++++++++++*@%          ###########@.          @@    @                 @*+++++++++++++@.         :@@######@#######@                 
        #@*++++++@@@#+++++++@@      .########@                 @@@                .@++++++++++++++@@.       @@= @######@########                 
     @@+++++++@@     .@@+++++++@@   .####@@                       :              @*++++++++++++@@.          @++*@@#####@#######*                 
  @@++++++*@#            @@+++++++@@.#@.                              +        .@+++++++++++@@              @++++++@@##@#######:                 
 =@#+++*@#                  %@*+++%@:                                    @    @#+++++%+++@@                  @@*++++++@@#######.              .@@
    :@%                        .@#                                           @@+++=@=#@@.                       =@#++++++*@@###            *@#+++
       .@@                      @++@@                                           @@=+==@                            .@@+++++++@@         @@+++++++
          .@@=@@+=@@            @+++++@@                                           @@#@                                @@+++++++@@.  @@+++++++@@.
              @@==+@            +@*++++++@@                                          @@                                   @@+++++++@+++++++@@    
                 @@@               -@#++++++@@                                    @@++@                                      @@*+++@++++@@       
                -@%@                  :@%++++++@@                             .@@+++++@                                         +@#@*@@          
             @@*+++@                     .@@++++++@@.                      =@#+++++++@@                                            .             
          @@++++++*@                         @@++++++%@:                @@*+++++++@@                                                             
       @@++++++@@.                              @@++++++*@+          @@+++++++#@*                                                                
   #  -@+++*@@                                     @@++++++*@@    @@+++++++@@.                                                                   
:       @@.                                           @@+++++++@@+++++++@@                                                                       
         @                                               @@++++*+++++@@                                                                          
          @.                                                @@+*+*@#                                                                             
           @#                                                  @:                                                                                
#           :@                                                                                                                                   
*@            @                                                                                                                                  
++@            @                                                                                                                                 
+++@            @.                                                                                                                               
++++@-           @@                                                                                                                              
+++++#@           .@                                               @=%@.                                                                         
