                                                                           @###########@#%=#                                                     
                                                                           ######@######**%==@                                                   
                                                                           ######@######@@@=@*.                                                  
                                                                           ######@#######@  @@=@                                                 
                                                                           ######@#######@     @@                                                
                                                                           ###############        @@.                                            
                                                                           ##############-           #@:                                         
                                                                         .@  @##%########.              -@+                                      
@                                                                       @-      @########.                 .@@                                   
  @@                                                                   @           @#####                      @@                                
     @@.                                                             +@               @%%                         @@                             
        =@=                     @%#%@                               @.                 @@@@                          @@                          
           .@%                @##@####@                           .@                  @+@+++@@                          @@.                      
               @@           @####@#####@                         @%                 %@++@++++++@@                          *@:                   
                  @@       @#####@#####@                        @                  @++++@ @@++++++@@                          :@*                
                     @@.  .######@#####@                      .@                 =@+++++@    @@++++++@@@######@                  .@@             
                        %@@######@#####@                     @=                 @+++++++@       *@*+++@#########@                    @@          
                         .#######@#####@  %*@               @                 :@++++++++@          -@############@                      @@ @@#===
                         .#######@#####@*@=%=@            =@                 @*+++++++++@            =######%#####@                        @@====
      @@@%               .#######@#####@==@@@==@         @.                .@+++++++++++@            %######@######@                          %@=
   @@++*+++@@            .#######@#####@@     @@        @                 @*++++++++++++@            @######@#######.                            
@@+++++*++++++@@         .#######@##@*           %@-  @@                .@++++++++++++++@          @@@######@#######-                           @
+++++@@ @@+++++++@@.     :#######@                  .@                 @#+++++++++++++*@+        @@@ @######@#######.                        @@++
++@@       @@+++++++@@:  :###%@                         *             @++++++++++++*@=           @+++@@#####@#######.                    :@@+++++
@             =@%++++++*@#@#                               *        @%++++++++++*@+              @++++++#@%#@#######                  @@*++++++@@
                  @@++*@@                                     ..   @++++++@*+*@=                  .@@+++++++@@######               @@+++++++@@   
                     @@                                           @@*+@====@=                         @@+++++++@@###           .@@+++++++@@      
       @.            @++@@                                           =@@#==@                             @@+++++++%@:       %@#+++++++@@         
@@==@@==@           .@+++++@@.                                          .@@@                                @@*++++++*@@ @@+++++++*@+            
   @@===%             @@++++++@@.                                        %@@                                   +@#++++++@++++++@@.               
      %@%                @@++++++#@-                                  @@+++@                                      .@@+++@+++@@                   
     @@+@                   @@++++++*@+                            @@++++++@                                          @@@@@                      
 -@%++++@                      @@+++++++@@                     .@@+++++++@@.                                                                     
*++++++@@                         @@+++++++@@               .@%+++++++@@                                                                         
+++%@+                               @@+++++++@@         +@*+++++++@@                                                                            
@@                                      %@*++++++@@   @@*++++++*@#                                                                               
                                           +@*++++++@+++++++@@:                                                                                  
                                              -@#+++@++++@@                                                                                      
.                                                .@@@+@@                                                                                         
@@                                                                                                                                               
 .@                                                                                                                                              
   @                                                                                                                                             
    @                                                                                                                                            
     @:                                                                                                                                          
