                                                                                                                                                 
                                                                                                                                                 
                                                   -@###%@.                                                                                      
                                                  @####@###@ %@=@                                                                                
                                                 @#####@#####====@                                                                               
                                                @######@#####@==#=@                                                                              
                                                @######@######**@===                                                                             
                                                @#############% :@#=@=                                                                           
                                                @##############    .@@                                                                           
                                                @#####@########        @@                                                                        
                                                @#####@#######%           @@                                                                     
                                               .@.@###@#######@              @@                                                                  
                                              @+    .@@#######@                 #@.                                                              
                                             @         .@#####@                    =@=                                                           
                                           -@              @##@                       .@%                                                        
      =@@:                                @.                 *@=                          @@                                                     
    @######@                             @                  @+@+*@=                          @@                                                  
  @##########                          @@                 -@++@++++*@-                          @@                                               
 @###########@                        @                  @++++@@@+++++#@-                          @@.                                           
@############@                      .@                 :@+++++@   @@+++++#@- :@###@=                  #@:                                        
%############@                     @#                 @*++++++@      @@+++++@#####@##@                   -@+           +@@                       
#############@   @                @                 .@++++++++@         @@+@######@###%                     .@@  @ :=#@==@                       
#######%#####@ @@#+             :@                 @*+++++++++@            @######@#####.                       @@=@%====@                       
#######@#####@*===#@@          @:                .@+++++++++++@            @######@######                          @@+=#=@                       
#######@#####@@@  :@@         @                 @#++++++++++++@            @######@######@                            @@=@                       
#######@###@.         @@    #@                 @++++++++++++++@          =@@######@######%                            .@@                        
#######@@                #@@                 @%++++++++++++++@@        @+  %######%######@                         :@%++@                        
####@+                      :.              @+++++++++++++@@           @++@@#############@                      @@*+++++@                        
#@.                             +         @@+++++++++++@@             +#+++++@@##########@                   @@+++++++@@                         
                                   #     @++++++++++@@                 #@*++++++%@#######@               .@@+++++++@@                            
                                      .@@+++@@@@=@@                       -@%++++++*@@###@            #@*++++++*@#                               
                                          @@=%===#                           .@@+++++++@@@         @@+++++++@@:                                  
@@                                           *@#=#                               @@+++++++@@.  .@@+++++++@@                                      
+++@@                                           @@                                  @@+++++++*#+++++++@@                                         
++++++@@                                    .@@++@                                     %@*+++++++++@@                                            
.@@++++++@@.                             :@%+++++@                                        =@#++*@*                                               
   .@@++++++@@.                       #@*+++++++@*                                           ..                                                  
       @@++++++#@-                 @@+++++++*@%                                                                                                  
          @@++++++*@*           @@+++++++%@-                                                                                                     
             @@+++++++@@     @@+++++++@@.                                                                                                        
                @@+++++++@@@+++++++@@                                                                                                            
                   @@+++++@+++++@@                                                                                                               
                      %@++@+#@+                                                                                                                  
                         *@.                                                                                                                     
