                                                                                                                                                 
                                                        -@@@:                                                                                    
                                                      %####@###-  :@                                                                             
                                                     @#####@####@=%=@                                                                            
                                                    @######@#####%==*@                                                                           
                                                    @######%#####@==%@=.                                                                         
                                                    @#############@@@=+@                                                                         
                                                    @#####%########   *@%                                                                        
                                                    @#####@#######@      -@*                                                                     
                                                    @#####@#######@         .@@                                                                  
                                                    @%####@#######@             @@                                                               
                                                  .@   #@#%#######@                @@                                                            
                                                 @=       =@######@                   @@                                                         
                                                @            -@###@                      @@.                                                     
                                              =@                .@@                         +@-                                                  
        =@@###@                              @.                 @@@@@                          :@*                                               
      .@##@#####@                           @                  @++*+++@@.                         .@@                                            
     @####%######                         @@                 #@+++@#+++++@@                           @@                                         
    +#####%######-                       @                  @++++*# :@%+++++@@    .@@@                   @@                                      
@@  %############=                     .@                 =@+++++*%    .@@+++++@@#####@#@                   @@.            @.                    
   @#############=                    @+                 @+++++++*%        @@++@######@###@                    #@.      @.@==@                   
   @#############= @==@              @                 -@++++++++*%           @@######@####@                      =@===#====@@                   
   @#############@=%=#*@           -@                 @*+++++++++*@            @######@#####@                        .@@=+%==@                   
   @#############*=@@@@=@         @.                .@+++++++++++*@            %######%######:                           @@==%                   
   @#######%####@@      -@#      @                 @*+++++++++++++@           .##############@                              @:                   
   @#######%#@              @@ @@                .@+++++++++++++++@        @@. ##############@                          .@@+@                    
   @#####@#                    .                @#+++++++++++++@@         :@%@-##############@                       @@*++++@                    
@  @##@.                          :.           @++++++++++++@@            @*+++*@@###########@                    @@+++++++@@                    
++@@                                  =      @%++++++++++@@               @@+++++++@@%#######@                .@@+++++++@@                       
@                                        @  @+++*+@@+*@@                     @@+++++++@@#####@             +@#++++++*@%                          
@-                                          .@@@==+#=.                          #@*++++++*@@#@          @@+++++++%@:                             
++*@+                                           @@=*=.                             :@%+++++++@@      @@+++++++@@.                                
+++++*@%                                           @@.                                .@@+++++++@@@%+++++++@@                                    
@@+++++++@@                                      .@@*#                                    @@+++++*++++++@@                                       
   #@*++++++@@                                :@%+++#=                                       @@++#++*@*                                          
      =@*++++++@@                          *@*++++++@:                                          @@@:                                             
         -@#++++++@@                    @@+++++++*@@                                                                                             
            .@%++++++@@.             @@+++++++#@=                                                                                                
               .@@++++++@@.       @@+++++++@@.                                                                                                   
                   @@++++++#@=.@@+++++++@@                                                                                                       
                      @@++++++%++++++@@                                                                                                          
                         @@+++%++#@*                                                                                                             
                            @@@@.                                                                                                                
                                                                                                                                                 
