                                                                                                                                                 
                                                                                                                                                 
                                                                                                                                                 
                                             @%#%@+                                                                                              
                                           @####%###@ .@*@                                                                                       
                                          @#####@#####%===@                                                                                      
                                         @######@#####@==%#@                                                                                     
                                         @######@######%%==@=                                                                                    
                                         @######%######@ @@=*@                                                                                   
                                         @##############.   @@.                                                                                  
                                         @#####%########       +@=                                                                               
                                         @#####@#######%          .@%                                                                            
                                         @@%###@#######@              @@                                                                         
                                       +@    @%@#######@                 @@                                                                      
                                      @.        #@#####@                    @@                                                                   
                                     @             +@##@                       @@.                                                               
..                                 @@                 -@                          %@.                                                            
####@                             @                  @#@+@@                          =@=                                                         
#####@                          .@                  @++@++++@@                          .@%                                                      
######@                        @=                 @%+++@@*+++++@@                          .@@                                                   
######@                       @                  @+++++@  -@#+++++@@   @@%%@                   @@                                                
######@                     =@                 @@++++++@     .@%+++++@#####@##@                   @@            %@:                              
######@   =                @.                 @++++++++@         @@+@######@###@                     @@.  .  @@@==@                              
%#####@ @=+=              @                 @@+++++++++@            @######@####%                       *@*=%*====@                              
@#####@====%@:          %@                 @+++++++++++@            @######@#####%                         :@##=*=@                              
@#####@@@  @@@         @                 *@++++++++++++@            @######@######@                           .@@=@                              
@###@@        -@#    .@                 @++++++++++++++@           @@######@######%                             #@:                              
@@:               @@@*                =@++++++++++++++*@        @%  @######%######%                          @@++@                               
                     @               @+++++++++++++*@+          @+@@%#############@                      .@@+++++@                               
                        - .        :@+++++++++++*@=            :@++++*@@##########@                   +@#++++++%@-                               
                           .-     @*+++++++++*@+                @@+++++++@@#######@                @@+++++++@@.                                  
                               *.@+++@@@@=%@=                      @@+++++++@@####@             @@+++++++@@                                      
                                  .@@@===+%                           @@*++++++#@%@         =@%+++++++@@                                         
                                      @@=+%                              =@#+++++++@@    @@+++++++*@#                                            
                                         @@                                 .@@+++++++@@+++++++#@-                                               
@                                     @@++@                                     @@+++++*++++@@.                                                  
++@@                               @@+++++@                                        @@++++@@                                                      
+++++@@                         @@+++++++%@                                           @@                                                         
@*++++++@@                  .@@+++++++@@.                                                                                                        
  -@#++++++@@            -@#+++++++@@                                                                                                            
     .@%++++++@@.     #@*++++++*@@                                                                                                               
        .@@++++++%@@@+++++++%@-                                                                                                                  
            @@+++++@+++++@@.                                                                                                                     
               @@++@++@@                                                                                                                         
