                                                                                                                                                 
                                                                                                                                                 
                                                                                                                                                 
                                                                                                                                                 
                                                                                                                                                 
                                 @###@@:                                                                                                         
                               .#########*.@#@                                                                                                   
                              -###########@@%=#                                                                                                  
                              ######%######=%==@.                                                                                                
                              ######@######@#%==@                                                                                                
                              ######@#######* @@=@%                                                                                              
                              ######@#######@    @@                                                                                              
                              ######%#######%       @@                                                                                           
                              ##############*          @@.                                                                                       
                             @ @###%########:             *@-                                                                                    
                            @     @@########.                :@*                                                                                 
                          @@         @######.                   .@@                                                                              
                         @              @###                        @@                                                                           
                       .@                  @@                          @@                                                                        
                      @-                 #@%++@@                          @@                                                                     
                     @                  @++@+++++@@                          %@.                                                                 
                   +@                 +@+++@@@++++++@@                          =@=                                                              
                  @.                 @+++++@   @@++++++@@  @%##@@                  .@@                                                           
                 @                 :@++++++@      @@*++++@########@                    @@           @#@.                                         
               @@                 @*+++++++@         +@*+###########%                     @@  +. @*@===:                                         
@             @                 .@+++++++++@            :######%#####@                       @@==+=*===.                                         
=@.         .@                 @*++++++++++@            #######%######@                         @@+===+                                          
@@         @=                .@++++++++++++@            @######@#######                            #@+@                                          
   @@.    @                 @#+++++++++++++@           @@######@#######=                            %@@                                          
      :@@@                 @++++++++++++++*@        @@  @######@#######:                         @@++*@                                          
         .-              @%++++++++++++*@#          @++@@######@#######.                     .@@+++++#+                                          
             @          @+++++++++++*@*             @+++++@@###@#######                   =@%++++++#@=                                           
                :     @@+++++++++*@*                :@%++++++*@@#######                @@+++++++@@.                                              
                     @*++*@@@=@@*                       @@+++++++@@####             @@+++++++@@                                                  
                       %@*@===@                            @@+++++++@@%         :@%+++++++@@                                                     
                          .@@=@                               @@+++++++#@*   @@*++++++*@@                                                        
                             +@                                  %@*+++++++@+++++++#@=                                                           
                          @@*+@                                     -@%++++@++++@@.                                                              
                       @@+++++@                                        .@@+@+@@                                                                  
                    @@+++++++%@                                            @                                                                     
                .@@+++++++@@                                                                                                                     
@@           :@%+++++++@@                                                                                                                        
+++@@     %@*++++++*@@                                                                                                                           
++++++@@@+++++++#@=                                                                                                                              
