@#############**==*#                                                                               ######@#######@     @@                        
@############@@=*=#@@.                                                                             ######%#######@        @@                     
@#########@     -@*=*%@                                                                            ##############%           @@.                 
@#####@@           .@@+                                                                           @  @###########*              +@-              
@##@.                  @@                                                                       @@      @########:                 :@%           
@@                        @@                                                                   @           @#####.                    .@@        
@ .@%                        @@.                                                             .@               @##                         @@     
@    :@=                        *@:                     @@%@@                               @*                 :@@@                          @@  
@@      -@:                        :@*                @##@####@                            @                  @**+++@@                          @
   @@      #@.                        .@@           *####@#####@                         :@                 .@++@++++++@@                        
      @@      @@                          @@       %#####@#####%                        @:                 @*+++@ @@++++++@@                     
         @@      @+                          @@    ######@#####%                       @                  @+++++@    @@++++++@%+%####%@          
 .          @@@%                                @@@######@#####%                     @@                 @#++++++@       #@*+++@#########@        
@=@*@@- . @@:                                     #######@#####%  .@@               @.                 @++++++++@          =@*###########@       
@%%=%#=@@                                         #######@#####%.@=+=@            .@                 @%+++++++++@            .############@      
%+=+@@                        :@@+                #######@#####%**=@@==@         @#                 @+++++++++++@            :#############@     
@@:                        *@*++++*@@             #######%#####%@:    @@        @                 @@++++++++++++@            #######@#######-    
                        @@+++++*++++++@@          #######%##%@           %@:  :@                 @++++++++++++++@          @@@######@#######@    
                     @@++++++@@.@@+++++++@@      .#######@+                 .@-                @@++++++++++++++@@        @@@ @######@#######=    
                  @@++++++@@.      @@+++++++@@.  .####@.                        =             @+++++++++++++@@           @+++@@#####@#######-    
              :@%++++++@@.            #@#++++++#@+#@                               %        *@+++++++++++@@              @++++++%@##@#######.    
               @@+++@@.                  .@@+++@@                                     ..   @++++++@*++@@                  :@@++++++*@@######.    
                  @@                         @@                                           @@*+*=+==@@                        .@@+++++++@@###     
                     @@        :.            @++@@                                           *@%@==@                             @@+++++++@@.    
                        @@==@#=+@            @+++++@@                                           .@@@                                @@+++++++*@% 
                           @@===@            .@@++++++@@.                                        .@@                                   %@*++++++@
                              @@@                @@++++++%@.                                  +@#++@                                      :@%+++@
                             @@+@                   @@++++++#@=                            @@*+++++@                                         .@@@
                          @@++++@                      @@++++++*@%                      @@+++++++*@%                                             
                      :@%++++++@@                         @@+++++++@@                @@+++++++@@:                                                
                   %@*+++++*@@                               @@+++++++@@          @@+++++++@@                                                    
               .=  .@+++@@.                                     %@*++++++@@   :@%+++++++@@                                                       
            @        @@                                            *@*++++++@*++++++*@@                                                          
        .@            @                                               =@*+++#++++%@:                                                             
     .@%++@            @:                                                :@##+@@                                                                 
  .@@++++++@:           *@                                                  .                                                                    
#@++++++%@++%@           .@                                                                                                                      
+@++*@@  @++++@            @                                                                                                                     
@@@.     @+++++@            @                                                                                                                    
         @++++++@.           @-                                                                                                                  
         @+++++++@#           +@                                                                                                                 
         @++++++++*@           .@                                               @=@%-                                                            
         @++++++++++@            @                                            @=#=@=@                                                            
         @+++++++++++@            @                                           =@====@                                                            
