                                                                        @##########=%@+@                                                         
                                                                       %#####@#####@=*=@.                                                        
                                                                      .######@######@+=+=@                                                       
                                                                      .######@####### @@=#*                                                      
                                                                      .######@#######@   @@@                                                     
                                                                      .###############      @@                                                   
                                                                      .##############-         @@                                                
                                                                      %@####%########.            %@:                                            
                                                                     @.   @#@########                -@+                                         
                                                                   .@        @#######                   .@%                                      
@.                                                                @@            @###%                      .@@                                   
  @@.                                                            @                 @@                          @@                                
     =@+                   @#%##%#                             :@                  @%+@@                          @@.                            
        .@@              @###%####@                           @-                 @@+@++++@@                          @@.                         
            @@          @####@#####@                         @                  @+++@@++++++@@                          +@-                      
               @@      @#####@#####@                       *@                 %@++++@  @@++++++@@    %@@#                  :@#                   
                  @@. @######@#####@                      @.                 @++++++@     @@*+++++@%######%+                  .@@            @#  
                     %#######@#####@                     @                 +@+++++++@        *@*++##########@                     @@      #* ===.
                     .#######@#####@ .%%=*             @@                 @+++++++++@           -@######%#####.                      @@@=%==@=== 
                     .#######@#####@%*+@%=.           @                 -@++++++++++@            @######@######                         @@=====* 
 @@**@#              :#######@#####@=@@.@@=:        .@                 @*+++++++++++@            @######@######@                           @@==@ 
+++#++++@@           -#######@####@%       @@.     @=                :@+++++++++++++@            @######@#######:                             %@ 
+++@+++++++@@        -#######@#@:             +@+ @                 @*++++++++++++++@        .@@ @######@#######.                          @@++@ 
@@   @@+++++++@@.    =######@                    ..               .@+++++++++++++#@-         @+@@@######@#######.                      .@@++++#- 
        @@*++++++%@: =##@@                           % .         @*+++++++++++#@-            @++++@@####@#######                    *@#++++++%@. 
           -@%++++++*@*                                 =      .@++++++++++#@-               @#++++++#@%@#######                 @@+++++++@@.    
              .@@#@+                                       .: @#+++++#=@#@:                    .@@+++++++@@#####             .@@+++++++@@        
                 @@@                                           @@@@===#@                           @@+++++++@@#%          -@%+++++++@@           
@@:@@            @+++@@                                           :@@=@@                              @@+++++++%@=     @@*++++++*@@              
=%==@           :@++++++@@.                                          .@@                                 %@*++++++*@@@+++++++%@:                 
@@==*              @@++++++@@.                                      @@+@                                    =@#+++++@+++++@@.                    
   @@                 @@++++++#@-                                @@++++@                                       .@@++@++@@                        
@@++@                    @@++++++*@*                         .@@+++++++@                                          .@@@                           
++++@                       @@++++++*@@                   .@@+++++++@@                                                                           
+*@@                           @@+++++++@@             =@#+++++++@@                                                                              
.                                 @@+++++++@@       @@*++++++*@%                                                                                 
                                     @@*++++++@@ @@+++++++%@-                                                                                    
                                        *@*+++++@++++++@@.                                                                                       
                                           -@#++@+++@@                                                                                           
                                              :@@@@                                                                                              
                                                                                                                                                 
                                                                                                                                                 
.                                                                                                                                                
@%                                                                                                                                               
