###@#####@#===@                                                                               @##############.  @@=:                             
###@#####@==@=%                                                                               @##############.     +@:                           
###@####@.@@+#==@                                                                             @#####@########         :@*                        
###@@@       @@*#=-                                                                           @%####@#######%            .@@                     
#@:             @@                                                                           @   @%#@#######@                @@                  
                   @@.                                                                     .@       @@######@                   @@               
                      =@=                                                                 @-           *@###@                      @@.           
@                        .@@                                                             @                =@@                         %@.        
  @@                        .@@                    @####@                              +@                  @@@@                          =@=     
     @@                         @@               @########@                           @.                 @%+@+++@@                          .@@  
@.     .@@                         @@          .###########-                         @                  @+++@*+++++@@                          .@
  +@:     .@*                         @@.      ############@                       @@                 @@++++@ =@#+++++@@     .==                 
     -@=   :@%                           -@*  @############@                      @                  @++++++@    .@@+++++@@#####@#@              
        @@.                                 .@#############@                    .@                 @@+++++++@       .@@++*######@###@            
*+.@@@@                                      @#######%#####@ :%+@              @=                 @+++++++++@           @@######@####@           
=%@@                                         @#######@#####@@=%@=@            @                 #@++++++++++@            @######@#####@          
.                        @@@@@               @#######@#####@=@@@@==         =@                 @++++++++++++@            @######@#######         
                      @@+++@+++@@.           @#######@####%@      #@=      @.                +@+++++++++++++@            @######@######%         
                   @@++++++@++++++@@:        @#######@#@=             @@  @                 @+++++++++++++++@        .@@ @######@######%         
               .@@++++++@@  @@*++++++*@*     @######@.                   @                :@+++++++++++++*@*         @@@.%######%######@         
            *@#++++++@@        :@@+++++++@@  @##%@                          +            @*+++++++++++*@*            @+++#@@###########@         
         @@*++++++@@               @@+++++++@@=                                .:      .@++++++++++*@+              *@+++++++@@########@         
           @@++@@                     @@+*@@                                       %  @*+++++#%%*@+                    @@+++++++@@#####@         
              @@.                       #@@.                                          -@@@@==@=@                          @@*++++++%@%#@         
                 #@: :  #. @.           @*++#@-                                           @@=%=%                             +@#++++++*@@      #@
                    =@*=====.           @++++++*@*                                           @@@                                .@@+++++++@@@@+++
                       :@#==              @@++++++*@@                                       @@*@                                    @@++++++*++++
                          .@                 @@+++++++@@                                 @@++++@                                       @@+++*++@@
                       .@@+@.                   %@*++++++@@                           @@+++++++@                                          @@@@   
                    -@%++++#+                      +@*++++++@@                     @@+++++++@@.                                                  
                 @@*++++++@@                          -@#++++++@@              :@@+++++++@@                                                      
              -@++++++@@-                                :@%++++++@@.       *@#++++++*@@                                                         
          =    -@+*@@                                       .@@++++++%@: @@*++++++#@*                                                            
       -         @                                             .@@++++++@++++++@@.                                                               
   #@@            @                                                @@+++@+++@@                                                                   
*@*+++@            @.                                                 @@@@@                                                                      
+++++++@.           @*                                                                                                                           
+++@@+++@*           :@                                                                                                                          
@-  @++++*@            @                                                                                                                         
    @++++++@            @                                                                                                                        
    @+++++++@            @.                                                                                                                      
    @++++++++@-           @#                                                 =                                                                   
    @*++++++++#@           :@                                              @=+=*                                                                 
    @*++++++++++@            @                                           -=*=%=@-                                                                
