                                                                                                                                                 
                                                                                                                                                 
                                                  :.                                                                                             
                                               @####%##@                                                                                         
                                              @#########@*=%@                                                                                    
                                             @###########@%%@#                                                                                   
                                             ######@#######*%==@                                                                                 
                                             ######@######@@@++--                                                                                
                                             ######@#######@  @@=@                                                                               
                                             ######@#######@     *@:                                                                             
                                             ##############%        :@+                                                                          
                                             %#############-           .@@                                                                       
                                           *@  @%#%########.               @@                                                                    
                                          @.      @@#######                   @@                                                                 
                                         @           *@####                      @@                                                              
                                       @%               =@#                         @@.                                                          
 .@%##@                               @                  @@@@                          +@-                                                       
%##@####@                           .@                  @+@+++@@                          :@#                                                    
###@#####@                         @-                 @@++@*+++++@@                          .@@                                                 
###@#####@                        @                  @++++@ +@#+++++@@       .                   @@                                              
###@#####@                      +@                 @@+++++@    :@%+++++@@@######@                   @@                                           
###@#####@                     @.                 @+++++++@       .@@+++@#########@                    @@          @===                          
###@#####@  @+@-              @                 @@++++++++@           @@###########@                      #@.@%@====*=.                          
###@#####@@@=%=@.           @@                 @++++++++++@            +######%#####@                        -@*==*===                           
###@#####@=+@@@==@         @                 +@+++++++++++@            %######@######@                          .@%==@                           
###@#####@@     #@-      .@                 @+++++++++++++@            @######@#######:                             @@                           
###@##@.           .@@  @+                -@++++++++++++++@         =@%@######@#######=                           @@+@                           
###@                   @                 @++++++++++++++@@.        @@@.@######@#######.                       :@@+++*@                           
*                         *            :@++++++++++++@@.           @+++#@%####@#######.                    @@*++++++@+                           
                             ..       @*++++++++++@@.              @+++++++@@#@#######                  @@+++++++@@                              
                                 %  .@++++++@@+@@.                   @@+++++++@@######              .@@+++++++@@                                 
                                    =@@#@==@=@                          @@+++++++%@%##           #@*++++++*@%                                    
                                        @@=%=@                             *@*++++++*@@       @@+++++++%@-                                       
                                           @@@                                :@@+++++++@@.@@+++++++@@.                                          
*@@                                        @@@                                    @@++++++@++++++@@                                              
++++@@                                 .@@+++@                                       @@+++@+++@@                                                 
*++++++@@                           .@@++++++@                                          @@@@#                                                    
 *@*++++++@@                     =@#+++++++@@                                                                                                    
    =@#++++++@@               %@*++++++*@@                                                                                                       
       :@%++++++@@.        @@+++++++#@+                                                                                                          
          .@@++++++@@.  @@+++++++@@.                                                                                                             
             .@@++++++@+++++++@@                                                                                                                 
                 @@+++@++++@@                                                                                                                    
                    @@@#@#                                                                                                                       
