                                                                                                                                                 
                                                                                                                                                 
                                                                                                                                                 
                                                                                                                                                 
                                       @%##@@.                                                                                                   
                                     .#########- @%@                                                                                             
                                    +###########@%@=@                                                                                            
                                   .######@######=*==@.                                                                                          
                                   .######@######@#%==@                                                                                          
                                   .######@#######:.@@=@+                                                                                        
                                   .######@#######@    @@                                                                                        
                                   .##############+       @@                                                                                     
                                   .##############-          @@                                                                                  
                                   @.@###%########.             @@.                                                                              
                                 .@    .@@########                 *@:                                                                           
                                @#         @######                    :@*                                                                        
                               @              @##%                       .@@                                                                     
                             :@                  @#                          @@                                                                  
                            @-                 %@@+*@*                          @@                                                               
=                          @                  @++@++++*@*                          @@                                                            
@                        *@                 +@+++@@@+++++*@*                          %@.                                                        
@                       @.                 @+++++@   @@+++++*@+  @@##@*                  =@=                                                     
@                      @                 -@++++++@      @@+++++@########@                   .@%           @@@                                    
@   @                @%                 @++++++++@         @@*+###########=                     @@  =  @%@===.                                   
@ #=@=*             @                 .@+++++++++@            =######%#####@                       @@==*=+===                                    
@@==%=+@.         .@                 @*++++++++++@            @######@######+                         @@+=*=*                                    
@@@. .@@         @=                .@++++++++++++@            @######@######%                            @@=@                                    
         @@     @                 @*+++++++++++++@           @@######@#######:                            *@@                                    
            #@%@                .@++++++++++++++*@        @@  @######@#######.                         @@++*@                                    
               ..              @#++++++++++++*@#          @++@@######@#######.                      @@+++++%:                                    
                   #          @+++++++++++*@%             @+++++@@###@#######                   =@%++++++#@+                                     
                      +     @%+++++++++*@#                *@*++++++#@@#######                @@+++++++@@.                                        
                         ..@+++#@@@=@@*                      :@@+++++++@@####             @@+++++++@@                                            
                             @@+%===@                           .@@+++++++@@%         :@@+++++++@@                                               
                                =@@=@                               @@+++++++%@:   @@*++++++*@@                                                  
                                   +@                                  @@+++++++*@+++++++#@+                                                     
                                @@*+@                                     %@*++++@++++@@.                                                        
                             @@+++++@                                        :@%+@+@@                                                            
@-                        @@+++++++%@                                           .@                                                               
++*@*                 .@@+++++++@@.                                                                                                              
+++++*@@           :@%+++++++@@                                                                                                                  
@@+++++++@@     *@*+++++++@@                                                                                                                     
   @@+++++++@@@+++++++#@+                                                                                                                        
      @@*++++@+++++@@.                                                                                                                           
