                                                                                                                                                 
                                                                                                                                                 
                                                                                                                                                 
                                                                                                                                                 
                                      @@@:                                                                                                       
                                    @#######@   @                                                                                                
                                  .#####@####@=*=@.                                                                                              
                                 .######@#####@==%@                                                                                              
                                 @######@######==+@=@                                                                                            
                                 @######@######@@@+=*                                                                                            
                                 @##############.  +@+-                                                                                          
                                 @##############.     :@#                                                                                        
                                 @#####@########         .@@                                                                                     
                                 @@####@########             @@                                                                                  
                                @   *@#@#######%                @@                                                                               
                              :@       =@######@                   @@                                                                            
                             @-           :@###@                      @@.                                                                        
                            @                .@@                         =@=                                                                     
                          +@                  @@@@.                         .@%                                                                  
                         @.                 @%+@+++@@.                         .@@                                                               
                        @                  @+++@#+++++@@.                          @@                                                            
                      @@                 @@++++@ .@@+++++@@     -*#                   @@                                                         
                     @                  @++++++@    .@@+++++@@#####@#@                   @@.            @                                        
                   .@                 @@+++++++@        @@++*######@###@                    *@:      %.:==+                                      
-#**              @-                 @+++++++++@           @@######@####@                      -@+@=@==#=@%                                      
*##*%            @                 %@++++++++++@            @######@#####@                        .@@=#@==@                                      
@@@@==         =@                 @++++++++++++@            @######@######@                           @@==@                                      
     :@%      @.                +@+++++++++++++@            @######@#######                              @@                                      
         @@  @                 @+++++++++++++++@        .@@ @######@#######                           @@+@.                                      
            @                -@+++++++++++++*@=         @%@-@######%######%                        @@++++@                                       
               :.           @*+++++++++++#@-            @+++*@@###########@                    +@%++++++%@                                       
                   +      .@++++++++++*@-              -@+++++++@@########@                 @@+++++++@@.                                         
                      %  @*+++++*+@#@-                    @@+++++++@@#####@              @@+++++++@@                                             
                         .@@@@==#=@                          *@*++++++*@@#@          :@@+++++++@@                                                
                             @@=+=@                             :@@+++++++@@      @@*++++++*@%                                                   
                                @@@                                .@@+++++++@@@@+++++++#@-                                                      
                               @@+@                                    @@++++++*+++++@@.                                                         
                            @@++++@                                       @@+++*++@@                                                             
                         @@+++++++@                                          %@@@                                                                
@.                   .@@+++++++@@.                                                                                                               
++@@.             -@#+++++++@@                                                                                                                   
+++++%@:       %@*++++++*@@                                                                                                                      
@@++++++*@+ @@+++++++#@=                                                                                                                         
   @@++++++@++++++@@.                                                                                                                            
