                                                                   %#######@   @                                                                 
                                                                 .#####@####%=@=@:                                                               
                                                                :######@#####@==#@                                                               
                                                                @######@######===#=@                                                             
                                                                @######@######@=@*=@                                                             
                                                                @##############.  .@%:                                                           
                                                                @##############.     .@@                                                         
                                                                @#####@########          @@                                                      
                                                                @@####@########             @@                                                   
                                                               @   .@#@#######%                @@.                                               
                                                             =@       .@######@                   *@:                                            
                                                            @.            @###@                      :@*                                         
                                                           @                 @@                         .@@                                      
@.                   @####@.                             @@                 .@@*@-                          @@                                   
  %@:              @########@                           @                  @*+@+++#@-                          @@                                
     :@#         :###########%                        .@                  @+++@@+++++#@:                          @@                             
        .@@      ############@                       @+                 @#++++@  @@+++++#@-    %@@:                  @@.                         
            @@  @############@                      @                  @++++++@     @@+++++#@#####@#@.                  +@-            @:        
               @#######%#####@                    -@                 @%+++++++@        @@++*######@###@                    :@%      @-:==+       
               @#######@#####@ #=*=.             @.                 @+++++++++@           @@######@####@                      .@@@=@==*=#@       
               @#######@#####@+@=+@*            @                 @@++++++++++@            @######@#####@                         @@=%#==@       
:              @#######@#####@=@@=@#=         @@                 @++++++++++++@            @######@######@                           @@==@       
+*@*           @#######@####@@      .@@      @.                @@+++++++++++++@            @######@#######                              @@       
+++++@@        @#######@#@              @@..@                 @+++++++++++++++@        *@* @######@#######                           @@+@.       
@+++++++@@     @#####%@                    =                *@+++++++++++++@@.         @*@@%######%######%                       :@@++++@        
  @@+++++++@@. @##@*                          .-           @++++++++++++@@.            @++++@@###########@                    @@*++++++@@        
     @@*++++++@@.                                 @      =@++++++++++@@.              :@*++++++@@########@                 @@+++++++@@           
        :@%@@.                                       -  @+++++*#=@@@.                    +@#++++++*@%####@             .@@+++++++@@              
          =#@@                                           @@@@====@                          .@@+++++++@@#@          %@*++++++*@%                 
          @*+++@@                                           @@+=+@                              @@+++++++@@.     @@+++++++#@-                    
          @*++++++@@                                           -@@                                 @@+++++++%@@@+++++++@@.                       
            :@#++++++@@                                       @@+@                                    @@++++++*+++++@@                           
               .@%++++++@@                                 @@++++@                                       *@*++*++@@                              
                  .@@++++++@@.                         .@@+++++++@                                          :@@@                                 
                      @@++++++%@:                   =@#+++++++@@                                                                                 
                         @@++++++*@=             %@*++++++*@@                                                                                    
                            @@++++++*@%       @@+++++++#@+                                                                                       
                               @@+++++++@@ @@+++++++@@.                                                                                          
                                  @@++++++@++++++@@                                                                                              
                                     @@+++@+++@@                                                                                                 
                                        %@@@*                                                                                                    
                                                                                                                                                 
                                                                                                                                                 
                                                                                                                                                 
