                                                                                                                                                 
                                                                                                                                                 
                                                                                                                                                 
                                                                                                                                                 
                                                                                                                                                 
                                 =%####@*                                                                                                        
                                @####%####-@%+@                                                                                                  
                               @#####@#####*===@                                                                                                 
                              @######@#####@=#@=@-                                                                                               
                              @######@######@@**=@                                                                                               
                              @######%#######  @@=@@                                                                                             
                              @##############.    @@                                                                                             
                              @##############        @@.                                                                                         
                              @#####@########           %@:                                                                                      
                             .@ @###@#######%              -@+                                                                                   
                            @+     @@#######%                 .@@                                                                                
                           @          @#####@                    .@@                                                                             
                         -@              @%#@                        @@                                                                          
                        @.                 *@@                          @@                                                                       
                       @                  @+@++@@                          @@.                                                                   
                     %@                 =@++@+++++@@                          *@:                                                                
                    @                  @++++@@@++++++@@                          :@*                                                             
                  .@                 :@+++++@   @@++++++@@ +@###%@                  .@@                                                          
                 @*                 @*++++++@      *@*++++%#####@##@                    @@           #=@                                         
.               @                 .@++++++++@         -@#@######@####-                     @@  @.:==@==*                                         
%.            :@                 @*+++++++++@            @######@#####*                       @@=%=====@                                         
@+@.         @:                .@+++++++++++@            @######@######                          %@*===@                                         
 @@         @                 @#++++++++++++@            @######@######@                            =@*@                                         
    %@:   #@                 @++++++++++++++@          %@@######@#######                            .@@-                                         
       .@@                 @%++++++++++++++@@        @@  @######@#######                         *@#++@                                          
           +              @+++++++++++++@@           @++@@######%######@                      @@++++++@                                          
              #         @@+++++++++++@@             .@+++++%@%#########@                  .@@+++++++@@                                           
                 ..    @++++++++++@@                 .@@++++++*@@######@               =@%++++++*@@                                              
                     %@*++@@@@*@@                        @@+++++++@@###@            @@+++++++%@-                                                 
                        +@@#===@                            @@+++++++@@@         @@+++++++@@                                                     
                           .@@=@                               @@+++++++*@@  :@@+++++++@@                                                        
                             .@@                                  +@#+++++++#+++++++@@                                                           
                          :@%++@                                     .@@++++*+++*@%                                                              
                       *@*+++++@                                         @@+*%@:                                                                 
                    @@*+++++++@%                                            .                                                                    
                 @@+++++++#@+                                                                                                                    
+@@           @@+++++++@@.                                                                                                                       
++++@@    .@@+++++++@@                                                                                                                           
*++++++@@%+++++++@@                                                                                                                              
