                                                                                                                                                 
                                                           @###@#%@                                                                              
                                                          %####@####@*===                                                                        
                                                        .######@#####=%#=@                                                                       
                                                        @######%#####@+#==++                                                                     
                                                        @#############%@=%=@                                                                     
                                                        @#############%  @@*=.                                                                   
                                                        @#####@#######@     +@-                                                                  
                                                        @#####@#######@        :@*                                                               
                                                        @#####@#######@           .@@                                                            
                                                       @. @%##@#######@               @@                                                         
                                                      @      %@#######@                  @@                                                      
                                                    @@          +@####@                     @@.                                                  
                                                   @               -@#@                        %@.                                               
             *@#%@.                              .@                  @@@.                         =@+                                            
           @##@####@                            @-                 %@+%++@@                          .@@                                         
          @###%#####%                          @                  @+++%+++++@@                           @@                                      
@:       #####%######-                       =@                 *@+++**-@#+++++@@                           @@                                   
  -@*   @############-                      @.                 @+++++*#   .@@+++++@@ @####@@                   @@                                
     .@@#############-                     @                 -@++++++*%      .@@+++%######@##@                    @@.         +==@               
       @#############=  @%%              @@                 @++++++++*%          @@@######@####:                     #@: @@@==##=@               
       @#############=@*==#*            @                 .@+++++++++*@            @######@#####-                       -@#==@===@               
       @##############==@@==#         .@                 @*++++++++++*@            %######%#####%                          .@@==@@               
       @#############@%    #@=       @=                .@+++++++++++++@            ##############@                             @@:               
       @#######%##@           .@@   @                 @*++++++++++++++@         #@+##############@                           .@@@                
*      @######%@                  @@                .@++++++++++++++@@.        @@..##############@                        +@#+++@                
++@@   @###@-                        *             @#++++++++++++@@           **++#@@############@                     @@+++++++@                
+++++@@@@                               .:        @+++++++++++@@              @+++++++@@#%#######@                  @@+++++++@@                  
@+++@@.                                     %   @@+++++%@++@@                   @@+++++++@@######@              -@@++++++*@@                     
  @@.                                          =@@++%=%=%@                         @@*++++++%@%##@           @@*++++++#@+                        
  @++#@=                                           @@#%==.                            +@#++++++*@@        @@+++++++@@.                           
  @+++++*@#                                           @@=.                               .@@+++++++@@ .@@+++++++@@                               
   @@+++++++@@                                         @@%                                   @@++++++*+++++++@@                                  
      @@+++++++@@                                  .@@++*+                                      @@+++*+++*@@                                     
         #@*++++++@@                            -@#+++++%-                                         @@##@+                                        
            =@*++++++@@                      %@*+++++++@@                                                                                        
               :@%++++++@@.               @@+++++++*@%                                                                                           
                  .@@++++++@@.         @@+++++++@@:                                                                                              
                     .@@++++++%@:   @@+++++++@@                                                                                                  
                        .@@++++++*@+++++++@@                                                                                                     
                            @@++++#+++*@%                                                                                                        
                               @@+#%@:                                                                                                           
                                  .                                                                                                              
                                                                                                                                                 
