                                                                                                                                                 
                                                                                                                                                 
                                                                                                                                                 
                                           ..                                                                                                    
                                         @###%##@                                                                                                
                                        %####@####@===@                                                                                          
                                       ######@#####@**=@                                                                                         
                                      @######@#####@==+==@                                                                                       
                                      @######%######@@#**@                                                                                       
                                      @##############  .@@==                                                                                     
                                      @##############      @@                                                                                    
                                      @#####@#######%         @@                                                                                 
                                      @#####@#######%            @@                                                                              
                                     @. .@##@#######@               @@.                                                                          
                                    @       @#######@                  +@-                                                                       
                                  @@           @####@                     :@#                                                                    
                                 @                @#@                        .@@                                                                 
*                              .@                  @@@*                          @@                                                              
##=                           @+                 #@+@++*@+                          @@                                                           
###                          @                  @+++@+++++*@+                          @@.                                                       
###@                       -@                 =@++++@ @@+++++*@=                          #@:                                                    
###@                      @.                 @++++++@    @@+++++*@=@####@@=                  -@+                                                 
###@                     @                 :@+++++++@       @@+++*######@###:                   .@@         .==*                                 
###@  @=@              %@                 @*++++++++@          %@@######@####@                      @@ %@@==%#=@                                 
###@@+===@            @                 .@++++++++++@            @######@#####@                        @@==%===@                                 
###@==@@#==         .@                 @*+++++++++++@            @######@######.                          @@===@                                 
###@*     @@       @*                .@+++++++++++++@            @######@######@                             @@@                                 
@            @@.  @                 @#++++++++++++++@         @@:%######%######@                           .@@@                                  
                -@                .@++++++++++++++@@.        @@@ %#############@                        @@*+++@                                  
                    :            @%++++++++++++@@           .@+++@@############@                     @@+++++++@                                  
                       %        @+++++++++++@@              @*++++++@@#########@                 .@@+++++++@@                                    
                          -   @@+++++*@++@@                   =@#++++++*@@#####@              +@#++++++*@#                                       
                              @@++@=*==@                         .@@+++++++@@##@           @@+++++++%@:                                          
                                 @@@%==*                             @@+++++++@@.       @@+++++++@@                                              
                                    :@@*                                @@+++++++#@=-@%+++++++@@                                                 
                                    .@@@                                   @@++++++++++++++@@                                                    
                                 :@%+++@                                      *@#++++++*@#                                                       
%@.                           *@*+++++*@                                         .@@%@:                                                          
+++#@=                     @@++++++++@@                                                                                                          
++++++*@#               @@+++++++#@=                                                                                                             
 @@++++++*@@         @@+++++++@@.                                                                                                                
    @@+++++++@@  .@@+++++++@@                                                                                                                    
       @@+++++++@+++++++@@                                                                                                                       
          @@*+++@+++#@+                                                                                                                          
