                                                                              .######@#####%=++=@.                                               
                                                                              .######@######@#@==@                                               
                                                                              .######@#######:.@@=@*                                             
                                                                              .######@#######@    @@                                             
                                                                              .##############=       @@                                          
+@                                                                            .##############:          @@                                       
%=-                                                                           @.@###@########.             %@.                                   
 .@@                                                                        .@     @@########                 =@-                                
     @@                                                                    @=         @######                    :@#                             
        @@                                                                @              @##%                       .@@                          
           @@.                       ++:                                =@                  @%                          @@                       
              +@-                 %##%###@                             @.                 @@@+*@#                          @@                    
                 .@@            .%###%#####-                          @                  @++@++++*@@                          @@.                
                     @@        +#####@#####@                        @@                 %@+++@@@+++++*@*                          #@:             
                        @@     ######@#####@                       @.                 @+++++@   @@+++++*@#  @%##@%                  -@+          
                           @@ @######@#####@                     .@                 +@++++++@      @@+++++@########@                   .@@       
                             :#######@#####@   @                @*                 @++++++++@         @@*+######%####=                     @@  * 
                             :#######@#####@ @=@==             @                 -@+++++++++@            *######@#####@                       @@=
           %:                :#######@#####@#==%++@.         -@                 @*++++++++++@            @######@######=                         
        @@+*+*@*             -#######@#####@@@. .@@         @:                :@++++++++++++@            @######@######%                         
     @@++++%+++++@@          =#######@###@%         @@.    @                 @*+++++++++++++@           @@######@#######.                        
 .@@++++++@@@+++++++@@       +#######@@.               =@@@                .@++++++++++++++*@        @@  @######@#######.                        
%++++++@@     @@+++++++@@    +#####@                      ..              @*++++++++++++*@+          @++@@######@#######.                     .@@
++++@@           @@*++++++%@:*#@%                             @          @+++++++++++*@+             @+++++@@###@#######                   #@#+++
+@@                 -@%+++++@@                                   =     @#+++++++++*@=                =@#++++++#@@#######                @@+++++++
                       .@@=                                         ..@+++#@@@=@@=                      .@@+++++++@@###%            .@@+++++++@@ 
@@                       @+@@                                           @@+@===@                            @@+++++++@@@         =@%+++++++@@    
   @@:@@@@@@@           .@++++@@                                           -@@=@                               @@+++++++%@-   @@*++++++*@%       
      @@==+=#            @@++++++@@.                                          %@                                  @@+++++++*@+++++++%@:          
         @@==              .@@++++++@@.                                    @@++@                                     +@*++++@++++@@.             
          @@@                  @@++++++%@:                              @@+++++@                                        .@%+@+@@                 
      .@@+++@                     @@++++++#@=                        @@+++++++@@                                           .@                    
   #@*++++++@                        @@++++++*@#                 .@@+++++++@@                                                                    
@@++++++*@@                             @@+++++++@@           =@#+++++++@@                                                                       
+++++@@                                    @@+++++++@@     @@*++++++*@%                                                                          
@%@@                                          @@+++++++@@@+++++++%@-                                                                             
 +@                                              @@*++++@+++++@@.                                                                                
   @                                                +@*+@++@@                                                                                    
    @                                                  -@@                                                                                       
     @.                                                                                                                                          
      @=                                                                                                                                         
       =@                                                                                                                                        
         @                                                                                                                                       
          @                                                                                                                                      
