#####@#####@==@+@                                                                               @##############.   %@.                           
#####@#####@===@%.                                                                              @#####%########       +@-                        
#####@###@   @@=%=@.                                                                            @#####@########          .@%                     
#####@#         @@=+                                                                            @@%###@#######%              @@                  
##@.               @@                                                                         =@    @%@#######@                 @@               
                      %@:                                                                    @.        %@#####@                    @@            
@                        -@+                                                                @             +@##@                       @@         
  @@                        .@@                                                           @@                 -@                          @@.     
     @@                         @@                  @######@                             @                  @%@+@@                          =@=  
@.      @@                         @@             :#########@                          .@                  @++@++++@@                          .@
  #@.     .@#                         @@         @###########@                        @#                 @@+++@@*+++++@@                         
     =@:     .@=                         *@:    -############@                       @                  @+++++@  -@#+++++@@   @@%%@              
        -@= =@*                             :@* @############@                     -@                 @@++++++@     .@@+++++@#####@##@           
  .      @@.                                   @#######%#####@   =                @:                 @++++++++@        .@@+%######@###@          
=@==@=@@                                       @#######%#####@ @=+=              @                 %@+++++++++@            @######@####%         
*=*@#                        -                 @#######@#####@====@@.          #@                 @+++++++++++@            @######@#####%        
@.                        @@+@+@@              @#######@#####@@@. @@@         @.                =@++++++++++++@            @######@######@       
                       @@++++@++++@@           @#######@###%@        -@#    .@                 @++++++++++++++@           @@######@######%       
                    @@++++++@@+++++++%@:       @#######@@:               @@@%                :@++++++++++++++*@        @@  @######%######%       
                :@%++++++@@    #@*++++++*@@    @#####@.                     @               @+++++++++++++*@*          @+@@%#############@       
             *@*++++++@@          .@@+++++++@@ @#%@                            - .        .@+++++++++++*@*            :@++++*@@##########@       
           @@++++++@@                 @@++++++@@                                  .=     @*+++++++++*@*                @@+++++++@@#######@       
              @@@@                       @@@*                                         #.@+++@@@@=@@+                      @@+++++++@@####@       
                 @@.                      #*%@.                                          .@@@===+@                           @@*++++++#@%@       
                    *@:@@:*@@=.           @++++#@-                                           @@=+%                              =@#+++++++@@    @
                       =@*==#=.           @@++++++*@*                                           @@                                 .@@+++++++@@++
                          .@#=               @@++++++*@@                                     @@*+@                                     @@+++++*++
                            @@.                 @@*++++++@@                               @@+++++@                                        @@++*+@
                        .@@++%:                    #@*++++++@@                         @@+++++++%@                                           @@  
                     +@#+++++*#                       +@*++++++@@                   @@+++++++@@.                                                 
                  @@++++++*@@                            -@#++++++@@            :@%+++++++@@                                                     
               = @+++++@@.                                  :@%++++++@@.     *@*++++++*@@                                                        
           %      @*@@                                         .@@++++++%@@@+++++++#@+                                                           
       ..          @                                               @@+++++@+++++@@.                                                              
    *@*@            @+                                                @@++@++@@                                                                  
 +@*++++@=           -@                                                  @@@                                                                     
*++++++++#@            @                                                                                                                         
+++*@@@++++@            @                                                                                                                        
@@.   @+++++@            @.                                                                                                                      
      @++++++@.           @*                                                                                                                     
      @+++++++%@           :@                                                                                                                    
      @+++++++++@            @                                                @%@                                                                
      @*+++++++++@            @                                             @#=*+=.                                                              
      @*++++++++++@.           @.                                          @==%**=:                                                              
