#######%#=@-                                                                                %#####@#######@ -@#%@                                
#%#####%@==%@                                                                               %#####@#######@    .@@                               
#%####%@=@==@@.                                                                             %#####@#######@        @@                            
#%#@@    @@=+=@@                                                                            %#####%#######@           @@                         
@:          *@+@                                                                           @.:@###########@              @@                      
               :@%                                                                       .@     .@########*                 %@.                  
                  .@@                                                                   @#         .@#####=                    +@-               
                      @@                                                               @              .@##.                       .@%            
.                        @@                      .@@@:                               :@                  @@:                         .@@         
 @@                         @@.                @##@####@                            @:                 @@+++#@:                          @@      
    @@                         +@=            %###@#####@                          @                  @++*+++++#@:                          @@   
@      @@                         .@@       .#####@######                        *@                 *@+++@ @@+++++#@:                          @@
  @@      @@                          @@    @#####@######                       @.                 @+++++@    @@+++++#@: @####@-                 
     @@@@.                               @@@######@######                     .@                 =@++++++@.      @@++++@######%##@               
   .@@                                     %######@######   @@               @@                 @++++++++@.         @@+@##########@              
*@*                                        %######@###### -@=+@             @                 :@+++++++++@.            ############@             
                        @@.                #######%######@@=@==%@         .@                 @*++++++++++@.           .#############@            
                     @@++*+%@-             ##############@@   :@@        @-                .@++++++++++++@.           .##############=           
                 .@@+++++*++++*@%          ###########@:          @@    @                 @*+++++++++++++@.         .@@######%#######@           
              =@#++++++@@@%+++++++@@       ########@                 %@@                .@++++++++++++++@@.       %@+ @######@#######@           
           @@*++++++@@      @@+++++++@@    ####%@                       :.             @#++++++++++++%@.          @++*@@#####@#######@           
        @@+++++++@@            @@+++++++@@ #@:                              +         @+++++++++++@@.             @++++++@@##@#######=           
       -@#++++@@                  *@*+++#@=                                    #    @%+++++#+++@@.                 %@*++++++%@#######-           
          :@@                        .@#                                           @@+++=@=#%@.                       -@#++++++*@@###.           
             .@@                      @++@@                                           @@=**=*                            .@@+++++++@@.        @@*
                 @@=@@==@@            @+++++@@                                           #@%*                                @@+++++++@@.  @@++++
                    @@=++@            =@#++++++@@                                          @@                                   @@+++++++@+++++++
                       @@@               :@%++++++@@                                    @@++@                                      @@*+++@++++@@ 
                      :@@@                  .@%++++++@@                             .@@+++++@                                         =@#@+@@    
                   %@*+++@                     .@@++++++@@.                      :@@+++++++@@                                            .       
                @@+++++++@                         @@++++++#@:                *@*+++++++@@                                                       
             @@++++++@@:                              @@++++++*@+          @@*++++++*@@                                                          
         +. :@+++*@@                                     @@++++++*@@    @@+++++++@@:                                                             
     .-       @@.                                           @@+++++++@@+++++++@@                                                                 
  @            @                                               @@++++*+++++@@                                                                    
@++@            @.                                                @@+*+*@@                                                                       
++++@.           @@                                                  #-                                                                          
++#++@%           .@                                                                                                                             
+ @+++*@            @                                                                                                                            
  @+++++@            @                                                                                                                           
  @++++++@            @:                                                                                                                         
  @+++++++@=           %@                                                                                                                        
  @++++++++*@           .@                                               %=*@.                                                                   
  @++++++++++@            @                                            %=+%=#@                                                                   
