#############%#==*@                                                                               ######@#######@    :@*                         
############%@=#==@*                                                                              ######@#######@       .@@                      
#######%#@@    @@=*=@@                                                                            ##############@           @@                   
######@:          @@=@                                                                           @ +@###########@              @@                
##%@                 +@=                                                                        @     -@########=                 @@             
-                       .@@                                                                   @#         .@#####:                    %@.         
.@@                         @@                                                               @              .@##.                       =@-      
.   @@                         @@                      .@@@.                               :@                  @@.                         .@%   
-      @@                         @@                 @##@####@                            @:                 @@*++%@.                         .@@
 :@+      @@                         @@.            %###@#####@                          @                  @++#+++++@@.                         
    .@%      @@                         -@+       .#####@######                        *@                 *@+++@.@@+++++@@.                      
       .@@      @*                         .@@    @#####@######                       @.                 @+++++@    @@+++++%@. @####@.           
          .@@@@.                               @@@######@######                      @                 =@++++++@       @@++++@#########@         
=@ @@.   .@@                                     #######@######   @@               @%                 @++++++++@          @@+%##########@        
@==@#=+@*                                        #######@###### -@=#@             @                 :@+++++++++@             ############@       
*=+@@.                        @@                 #######@######@@=@==@@         .@                 @*++++++++++@            .#############@      
@@                         @@++*+@@.             #######%######@@   +@#        @-                .@++++++++++++@            -##############:     
                       .@@++++++++++#@=          ###########@-          @@    @                 @*+++++++++++++@.         .@@######@#######@     
                    =@%++++++@@@*++++++*@@       ########@                 @@@                .@++++++++++++++%@.       @@: @######@#######@     
                 @@*++++++@@     .@@+++++++@@    ####%@                       =              @#++++++++++++%@.          @++*@@#####@#######%     
              @@+++++++@@            @@+++++++@@ #@-                              -         @+++++++++++%@.             @++++++@@##@#######-     
             #@*++++@@                  @@*+++#@*                                    @    @%+++++#+++%@.                 @@+++++++@@#######:     
                =@@                        -@-                                           @@++++@-%@@.                       *@*++++++#@%###.     
                   :@+                      @+*@#                                           @@==+=%                            :@%+++++++@@.     
                      .@@=@@+=@@            @+++++@@                                           @@*%                               .@@+++++++@@.  
                          @@==*@            #@*++++++@@                                          @@                                   @@+++++++@+
                             @@@               +@*++++++@@                                    @@++@                                      @@++++@+
                            .@@@                  -@#++++++@@                             .@@+++++@                                         %@*@+
                         *@#+++@                     :@%++++++@@                       .@@+++++++@@                                            . 
                      @@+++++++@                        .@@++++++@@.                +@#+++++++@@                                                 
                   @@++++++@@=                             .@@++++++%@:          @@*++++++*@@                                                    
               -. =@++++@@                                     @@++++++*@+    @@+++++++%@-                                                       
            =       @@:                                           @@++++++*@@+++++++@@.                                                          
        @            @                                               @@++++*+++++@@                                                              
     @@++@            @.                                                @@+*++@@                                                                 
  @@++++++@            @+                                                  @+                                                                    
@+++++++*++@+           -@                                                                                                                       
@+++@@* @+++*@            @                                                                                                                      
@@@     @+++++@            @                                                                                                                     
        @++++++@            @.                                                                                                                   
        @+++++++@:           @#                                                                                                                  
        @++++++++%@           :@                                               @=%@.                                                             
        @++++++++++@            @                                            #=*#=%@                                                             
        @+++++++++++@            @                                           =+====@                                                             
