                                                                                                                                                 
                                                                                                                                                 
                                                                                                                                                 
                                                                                                                                                 
                                                                                                                                                 
                                  #####%#@.                                                                                                      
                                 @#########@@=%@                                                                                                 
                                @###########@*%=%                                                                                                
                               .######@#######+%==@                                                                                              
                               .######@######@@%=#%                                                                                              
                               .######@#######@ .@@=@                                                                                            
                               .######@#######@     @@                                                                                           
                               .##############=        @@                                                                                        
                               .##############:           @@.                                                                                    
                              .@  @##@########.              *@:                                                                                 
                             @-      @########                  -@+                                                                              
                            @           @#####                     .@@                                                                           
                          +@               @#%                         @@                                                                        
                         @.                 @@@#                          @@                                                                     
                        @                  @+@++*@@                          @@                                                                  
                      @@                 #@++@+++++*@#                          @@.                                                              
                     @                  @++++@ @@+++++*@#                          *@-                                                           
                   .@                 =@+++++@    @@+++++*@#@#####%@                  :@#                                                        
                  @=                 @+++++++@       @@++++@#########@                   .@@          @==-                                       
#@               @                 :@++++++++@          #@*###########@                      @@ @@+===*==                                        
@=@            =@                 @*+++++++++@            +######@#####@                        @@==+===+                                        
@%==@         @.                .@+++++++++++@            @######@######@                          @@===%                                        
  .@@        @                 @*++++++++++++@            @######@#######.                            %@@                                        
      @@.  @@                .@++++++++++++++@          @@@######@#######:                           @@*@                                        
         :@                 @#+++++++++++++*@%        @@@ @######@#######.                        @@+++#*                                        
            .-            .@++++++++++++*@*           @+++@@#####@#######.                    .@@++++++@:                                        
                @        @%++++++++++*@*              @++++++@@##@#######                  #@*++++++%@-                                          
                   :    @++++++@++*@*                  :@%++++++*@@######               @@+++++++@@.                                             
                       @@*+@=*==@+                         @@+++++++@@##%           .@@+++++++@@                                                 
                          @@*@==@                             @@+++++++@@.       +@#+++++++@@                                                    
                             .@@@                                @@+++++++#@* @@+++++++*@%                                                       
                              %@@                                   %@*++++++@++++++%@-                                                          
                           @@+++@                                      -@#+++@+++@@.                                                             
                        @@++++++@                                         .@@@@@                                                                 
                     @@+++++++@@:                                                                                                                
@%               .@@+++++++@@                                                                                                                    
+++@@         -@#+++++++@@                                                                                                                       
++++++@@   @@*++++++*@@                                                                                                                          
@@+++++++@+++++++%@:                                                                                                                             
