                                                                              -%######%######=*.                                                 
                                                                              -%######%#####%++#+.                                               
                                                                              -%######%#####%*=**@.                                              
                                                                              -#######%#####@*+=+%+:.                                            
                                                                              -#######%##%+. :#%**+%+:                                           
                                                    .                         =######%#-.       .*%*%:                                           
                                                 :**#*-                       =###%+.              .+%+.                                         
                                                .**+*=+                       =@=.                    .=%*:.                                     
                                               .#+++*+*#                      -%+%=.                     .-##-.                                  
                                              .**+++*++#=.                    -%...+%=.                     .:#%-.                    .***=.     
                                            .=*=*+*%%+**++.                   -%.   .:*%-.                      :*%=.              .:%#@####%.   
                                            -#++@*:..:#%+%.                    .=%*.   .:#%:.                      .+@+.          .####%#####%:  
                                           -#@*..      .:*@=.                     .-%#.   .:##:                       .=@*.      .%####%%#####*  
                                        .-%*..            ..*@=.                     .-%#.   .:%#.                       .-@#.  .######%%#####*  
                                     .-@*..                  ..+@+.        :-.         ..-%#=@%:..                          .:%%-%#####%%#####*  
                                  .-@*.                          .=@@*@#+%@**=+=#.-*-   .+@*.                                  .%######%%#####*  
                               .-@*.                                 -@%+*+*=***+**+**%%-.                                     .%#######%#####*.#
                            .=@*.                                       -%%+=*+=**+%#:.                    ..-#-.              .%#######%#####@*=
                         .=@*.                                             :#%**@*.                     ..=@%*%*%@=.           .%#######%#####@@*
     ...             ..=@+.                                                   ..                     .:+@#*+++%++++#@+..       .%#######%##%#-.  
    :*#.            :@*.                                                                          .:*@#*+++*#%%#*+++++#@*:.    .@#######@*:      
   .%+#.            .@%@#:.                                                                    .-#%*++++*#%+.  .=%%*+++++*%#-. .@####%+.         
.+##++#.             ##++*%%=.                                                              .=%%*++++*#%=.        .-#@#+++++*%%=@%#-.            
+#++++#.             +#+++++*%%+..                                                          =@#*++*%%=.               :*@#*++*%%=.               
*++++*%-.            .=%%*+++++*#@*..                                                        ..=@@+.                     .=@@-.                  
+++%*:.:*%=.            .:#@#+++++*#@#:.                                                        ..=%*.       ..           .%##@*..               
%#:.     ..+%+.             .+@%*+++++*%%-.                                                        ..-%###%#*#%.          .%*++*#@#..            
.           ..=@*.             .:%@*+++++*%@+.                                                         .-%%=*+#.          .=@#*++++*@%:.         
               ..-@*.             ..*@#*++++*#@#.                                                        ..:%%#.            ..=@%*++++*@%:.      
                    :@#.              .=@%*+++++*@%:                                                       .*@@:                .=@%*++++*%@:.   
                       :%%:.             .:#@**++++*%@-.                                               .:%@*++%-                   .-@%*+++++%@-.
                          :%%:.              .+@#*++++*%@=..                                       ..-@%*++++*%-                      .-%%*+++++%
                             .#%-.              .-%%*+++++#@+..                                 ..=@%*+++**%%-.                          .-%%*+++
                                .*%=.               :#@#*++++#@#:.                           ..-:-@*++*#@*.                                  -%%*
                                   .+%+.               .+%%*++++*%%-.                    ..:-.    :@@#-.                                        :
                                      .+%+..              .-#@#*+++*%%=.              .-:.         .%=                                           
                                         .=%*:.              ..+@#*+++*#@+:.       .-%%*@-          .**.                                         
                                            .-##:.               .=%%*+++*#%#:. .-%%*++++%*.         .=#.                                        
                                               .:*%-.               .:*@#*+++*%%%*++++*#*+#%.         .:%.                                       
                                                  .:*%=.                .=%%*++%*++#%%=%*++*%.          :@:                                      
                                                      .+@+.                .:#@@%@=..  %*+++*@:          .%+                                     
                                                         .+@+.                ...      #*++++*@=          .+*.                                   
                                                            .=@*.                      #*++++++%#.         .-%.                                  
                                                             .:%@+                     #*+++++++*@.         .:%.                                 
