                                                                              :@#.                                 -@%=*=*=***=+*=*##@+.         
                                                                         ..:@#.                                       -@%==*+=**+%%-.            
                                                                      ..-%#.                                             :%%*+@#..               
                                                   ..               .-%#:                                                   ..                   
                                                  .#*             :%#:                                                                          .
                                                 .@+*              ##@#:.                                                                    .:*@
                                              .=#%***.             +#++*%%-.                                                              .-#%*++
                                             .-%++++*.             -%+++++*%%=.                                                          .=@#*++*
                                           .:#++*+++%-.            .=%%*+++++*#@*:                                                          .+%@*
                                     .....*#*++++%%-.:*%=.            .-#@#+++++*#@#:                                                          .=
                             .**#..-#**+*+=*++%%-.     ..+%+.            ..+@%*+++++*%%-.                                                        
                             .%++=++=*+=*=+%%:.           ..+%+.            ..-%@*+++++*%%+.                                                     
                             .#++=*+=*=+@#:.                 ..=@*.             .:*@#+++++*#@*.                                                  
                              +#==*++%%:.                       ..-@#.             ..=@%*++++**@#.                                               
                              :*=+@%..                             ..:%%:              .:%@*+++++*@%:.                                           
                              .@%.                                      :%%:               .*@#+++++*%@=.                                        
...                            %.                                          .#@-..              -%%*+++++#@+..                                  .-
###.                           #=                                             .*@=..              :#@#*++++#@#:.                           ..-::@
###*.                          =#.                                               .+%+..              .+%%*++++*@%-.                     .:-.    .
####.                          .%.                                                  .+%+..              .-#%**+++*%%=..             .::..        
###%:                           #:                                                     .=%*:.               .*%#*+++*#@+..       .:#%#@=         
###%:                           =*                                                        .-##:.               .=%%*+++*#@*:. .:#%*++++%*        
####-                           :@.                                                          .-##-.                :*@#*+++*%%%*+++++*++#%.      
####-                           .@-                                                             .:*%-.                .+@%*++#*++*%@+#*++*%:     
%###-                            ++                                                                .:*%=.                .-#%%%@*:.  #*+++*%-    
%###=                            .#                                                                   ..+@+.                ...      **++++*%+   
%##%*.                            %.                                                                     ..=@*.                      **++++++%#  
@@*..+@+.                         *+                                                                        .#@*                     *#+++++++*@:
..    ..=@*.  ..==.++.-*....    .=@+.                                                                    :%@*+#%.                    *#++++++++*@
           :@%#***+#+==+@*+@%*@@=.                                                                   .-@%*++++*@.                    *#++++++++++
              :%@**+*+*****%%-.                                                                  ..=@%+++++*%@=                      *#++++++++++
%:.              .#@*=+*@#:                                                                   ..+@#+++++*%%-                         *#++++++++++
+*%%-.              .**.                      .-=--::::........                            .:#@#+++++*@#:                            +#++++++++++
*+++*%@=.                                 ..+@#=#+++++****###%%%%@@@@@@@%%#**++=--:::::..-#@*++++*#@*:                               +%*+++++++++
=%%*+++*%@=.                       ..  .:#%*====#+++++++++++++++++++++++++++++++++++****##++++*#@+.                                   .=%%*++++++
  .-%%*+++*#@+:              ..  .:=.-##+=====*%#**##%%%%%%%%%####******+++++++++++++++++#+*%%=.                                         .-%%*+++
     .-#%*++++#@*:           .--:.=%+======#%+.                  ...::--=++**##%%%%@%%%%#@%-.                                                -#@#
        .:#%#++++#@#:        .-=*+=+===+%#-.                                                                                                    :
           .:*@#*+++*%%-   .=#*===+*===@-                                                                                                        
              ..+@#*+++*%%#+==#+===*===@-                                                                                                .**#:.. 
                 ..+@#*++%*===*=+==+===@-                                                                                                .*+=+***
                    ..=@%%*===*==*++===@-                                                                                                .++=++=#
                       ..*#==+#===+*===@-                                                                                                .++=%%-.
                         +#===**===+===@-                                                                                                .*@:.   
