                                                                         :#==+**==@=                     %:  .+@-.                      .#@-     
                                                                       .#=*+*@@@**+%=                    #*..   .*@-..                     .*@=..
                                                                      :%=*@#.   .#@**.                     -@*..   .#@-.                      .+@
                                                                     .%@#.         .*@=..                     -%*:.   :#%:.                      
                                                                  .-%*.               .+@=..                     -%#:.  .=@-                     
                                                               .=%*.                     .=%*:...::...*+:.-.       .:##%*:                       
                                                            .=%*..                          .=%%*%++##++=*=#+##=.-:+%+.                          
                                                         .=%+..                                .-#%++**++**++*+*%%-.                             
                                                      .=@+..                                      .-#%+*+#*+#%*:.                     .=%%+.     
                                                   .+@+.                                             .:*%%%+..                     .+%#*#**#@+.  
                               .:.              .+%+.                                                   ..                      .*@#*+++#*+++*#@*
                              .#+-            .#@-                                                                           :#@**+++*%@*@%*++++*
                             .+*+=             .%*%%-                                                                    .-%%*++++*%@=.. ..-%@*++
                           :#+*+*+             .@+++*%@=.                                                             .=@%*++++*%@=..        .:#@
                         .=%++**++             .%*+++++*#@*.                                                          .=@%++*%@=..              .
                       ..#+*+**+@@-              :@@*++++++*@#.                                                          .-@#.                   
           ...   .::::***++++@#.  .+@=..            .*@#*+++++*@%:.                                                         .-%#........::.      
          +*+=:=%**=+*=*=*%#.        .+@+..            .=%%*+++++*%@=.                                                         .:%@*##*=*%.      
          -#+=++=++=*=*%#.              .=%*:.            .:#@#*+++++#@+:                                                         .:#%+=+%.      
          .#*=++=+=*%*.                    .-%*:.             .+%#*+++++#@*:.                                                        .:#%#.      
          .#=++=#%*.                          .:##-.             .-#%*+++++*%#-.                                                    .:*@%@.      
           *=*%*.                                .:##-.              :*@#*++++*%%=.                                              .-#%#++*@.      
           **.                                      .:*%=.              .=%%*++++*#@+..                                       .=%%*++++*%@.      
           =*.                                         ..+%+.              .-#@#*+++*#@*:.                                 .+@#*+++*#%#-.        
           :%.                                            ..+%+.              ..+@%*++++*%#-.                          .:-:.+@*+*%%+..           
           .%:                                                .=%*.               .-%%*++++*%%=.                    .-:..    -@#:.               
            +=                                                   .-%#:               .:*@#++++*#@*.             .-%..         .%:                
            :%.                                                     .:%%:                .-@%*+++**@#:        -@%**@:          .%-               
            .%:                                                        .:#@-                .:%@*++++*@@-  -@%*++++*@-          .#+              
            .*+                                                            .#@-                 .+@%*+++*%@*+++++#%++%+           =%.            
             -#                                                               .*@=..               .-%@*+*#+**@@--@+++#%.          :@.           
             .%.                                                                 .+@+..               ..#@@@=.   -@++++*@:          .%:.         
              *-                                                                    .=@+..                       -@+++++*@-.         .%=.        
              =#.                                                                      .=%*:.                    -@+++++++%=.         .**.       
              :@.                                                                      .-#@@:                    :@++++++++%*.          =%.      
%*+#+:=+..:.:+%+.                                                                   .=%%*+*@-                    :@+++++++++#%.          :%.     
++++*+*##*%%-.                                                                   .+%%*++++*@-                    :@*+++++++++*@-          .%:    
++*+++*%*:.                                                                   :*@#*++++*%#-.                     :@*+++++++++++%=.         .%=   
@#+#@+..                                                                  .-#%#+++++#@*:.                        :@*++++++++++++%*.          **  
..:..                     .*%%%###**++=--:.....                        .-%%*++++*#@+:                            :@*+++++++++++++##.          =%.
                      .:#%+=#*++++++++*********####%%%%@@@%%%%%##**+=+%%*++++*%@=.                               .@%*+++++++++++++*@:          :%
               ..  .=%#=====**++++++++++++++++++++++++++++++++++++++*%++++*%@-.                                    .:%@*+++++++++++*@=          .
          :. .-:.+@+======#@=..::--=+*#%@@@@@@@%%%##***++++++++++++++%+*@%:.                                          .:#@*++++++++++%*.      .:-
         .=-..+%+======%@:.                    ...........:-=+*#%@@@@@#..                                                ..*@#++++++++##.   .-.  
