                                                                       =#*+++*#.                     .@-%%.                      .+@=.           
                                                                     .=#+==+*=##.                    .@: .-@#..                     .=@+..       
                                                                    :#=**+%@***=#.                   .@-.   .-@*..                     .-@*..    
                                                                  .:%=*%#:. .+@#*=                    ..#%-.   .=%=.                       -%#:. 
                                                                  .@%#:.       .=%*:.                    ..*%-.   .+%=.                       :#%
                                                               .-%*:.              -##:.                    ..*@=.   .#@.                        
                                                            .-%*:.                    -##-. ....  .+-..:.       .+@+##-.                         
                                                         .=%*:.                          :*%###+*##+==**+=**..:.+%*:                             
                                                      .=%*:.                                :*@*+++**+*+++++*%%=.                                
                                                   .=%*:                                       .+@*=*+*++#%#-.                     .-#*:         
                                                .=%*:                                             .=@##@*:.                     .=%%*#**%#:.     
                             ..              .=%+.                                                   ...                     .*@#*+++#++++*%%-.  
                           .#*.            .@#..                                                                          .#@#*++++#@%@*+++++*%@=
                          .#**.             =%%@+.                                                                     :%@*+++++#@+.. ..*@#+++++*
                        -##***:             :%++*#@*.                                                              .-@%*+++++#@+..       ..=@%*++
                       -@+*+**:             :@++++++*@%:                                                           :%@*+++#@+.                :@@
                 .  .:#+**+*+%*..            .*@#*+++++*@@-..                                                         :#@*..                     
        ..    ....:*#*++++%%:  -%*:.            .=@%*+++++*%@=..                                                         .#%-.... ...:.          
      .*##::-#*+=+*=*+*%#:        -%#:.             :#@#*++++*#@*:.                                                         .*%#*%#*##+          
      .#**=++=++=*+*%#:              :##-.             .*%#*+++++#@#:.                                                         .*@*=+*+          
       =*+=++=+=+%#:                    :*%=.             .=%%*+++++*%%-.                                                         .+%#=          
       :#+++=*%*:.                         .*%=.             .:*@#*++++*%@+.                                                      :+@@*          
       .#=*%*:.                               .+%+.              .+%%*++++*#@*:                                               .:*@#++##.         
        %*:.                                     .=%*..             .-#%#+++++#@#-                                         .-#%*++++*%%.         
        #-                                          .-%*..              :+@%*++++*%%=.                                  .=%%*++++*%%=.           
        +#.                                            .-##:.              .-%%*++++*#%+.                           ..-:.##++*%@+:.              
        :%.                                               .:#%:.              .:*@#*+++*#@*.                     .-:..   .*@%-.                  
        .%:                                                  ..*%-.              ..=@%*++++*@%:.              -+..        .=#.                   
         =+                                                     ..*@=.              ..:%@*++++*%@-.        :@%*##.          -@.                  
         :%.                                                        .+@+.                .*@#+++++%@+.  :@@*++++#%.          .@-                 
         .@:                                                           .=@+..               .-@%*++++#@@*++++***+*@-          .#=.               
          *+                                                              .=@*..                .#@#*+*#++*%@=+#+++%=.         .*+.              
          :#                                                                  -%#:.                .+@%%@*.   +#++++%*.         .=#.             
          .%.                                                                    :%#:.                        =%+++++##.          -@:            
           *=                                                                       :#%-.                     =%++++++*@.          .%-           
           =#.                                                                      .:#@@.                    =%+++++++*@=          .#=.         
*::--... .+%+.                                                                   .-%%*+*@.                    =%+++++++++%+.         .**.        
+#*+%%*@%=.                                                                   .=%%*++++*@:                    =%++++++++++##.         .=#.       
+++*%#-.                                                                   .*@#*++++*%%-.                     =%+++++++++++*%.          :@:      
#@*:.                                                                   :#@#*++++#@#:.                        =%++++++++++++*@:          .%-     
..                     .+##**+==-::...                               -%%*+++++#@*:.                           =%+++++++++++++*@+          .#+.   
                    :#@+=#+++++**********###%%%@@@@@%%%%##**+=--:.=%%*+++++#@+.                               -@#++++++++++++++##.         .+*.  
            ..   -%%+====%+++++++++++++++++++++++++++++++++++*****#++++*%@=.                                   ..*@#++++++++++++*@.          =%. 
      ... .-=.=@*======*@*:-=+*#%@@@@@@@@%%##****+++++++++++++++++%+*%@:.                                          .+@#++++++++++*@.        .-.-@
