                                                                               .#######%#####%*#@-                                               
                                                                               .%######%#####%#==*#.                                             
                                                                               .%######%#####%+**=#.                                             
                                                                               .#######%####%#@*#++*@.                                           
                                                                               .%######%%%=.   .=%#*+**.                                         
                                                   .:=.                        .%####%*:.         .-#@-.                                         
                                                  .*=*=#                       .%%#=.                .:##-.                                      
                                                 -#++**#=.                     .@#:.                    .:*%=.                                   
                                                .*+++*+*@.                     .%.-%*..                     .+%+.                                
                                              .-#+=+***==#+.                   .%.  .-%*.                      .=%*.                  .*%%%%#:   
                                              +++=*@*=%#=+#:                   .*%-.   .=%*.                      .-%#:             .*%#%%#####. 
                                            .*+*@*:.   .=%%+.                    .:*%-.   .=%+.                      .-#%:         :%###%%#####+ 
                                           .=@*..         .-%#.                     ..*%-.  ..+%=.                      .:#%-     :@####%%#####@.
                                        .-@*..               .:%#.                     ..*@-.  :%%.                        ..*@=. *######%#####@.
                                     .-@*..                     .:%%::=.*=. =#%==*        ..#@*..                             ..+@%######%#####@.
                                  .-@*.                             .#@+*+*+=*+==+@%+%-+%*@=.                                   .########%#####@.
                               .=@+.                                   .*@*+*+*=+#=+**%%:.                    ...               .########@#####@%
                            .=@+.                                         .*@*++*+*@#.                     ..=@@@*:.            .########@#####@+
                         .=@+.                                               .+@%+.                     ..+@%*+%*+*@#:.         .########@####%%+
      :*.            ..+@+.                                                                          .:*@#*+++*@*++++*%%-.      .########@#%#:.  
     =*#:            .%%=.                                                                        .-#@#++++*#%+:#@#*++++*%%=.   .%######%*.      
  ..-#=#:            .*#*%%+.                                                                  .-%%*++++*#%=.    ..*@#*++++*#@+..%##%#=.         
  *+*++#-             =%++++#@*:.                                                            -%%*++++*%%=.           .=%%*++++*#@@#-.            
=#+=*+*#-             :@#++++++#%#-.                                                         .-#%**%%=.                 .-#%**%#-.               
**=*+*%*%*.            .:*@#*+++++*%%=.                                                         .:#%-.                     .+@#-.                
*+*%*:.  .-%*:            ..=%%*+++++*#%+.                                                         .:*%-.:..=-:#:           *#+*%%=.             
@*:.        .-##:.            .:#@#+++++*#@*..                                                        .:*@#+*+=+-           *#++++*%%=.          
.              .:#%-.            ..=@%*+++++*@%:.                                                        ..+@#=+-           .:%@*++++*#@+.       
                  ..*@-.             .:%@*+++++*%@-.                                                        ..+@-              .:%@*++++*#@*.    
                      .*@=.              .*@#++++++#@+.                                                    .%@*#=                  .#@*+++++*@#. 
                         .+@+..             .=@%*+++++#@#..                                           ..:@@*+++#+                     .#@*+++++*@
                            .=@+..             .:#@#*++++*@%:..                                    ..=@%*++++*%@-                        .*@#*+++
                               .-%*:.              .+@#*++++*%@-..                              ..-@#*+++*#@#:                              .*@#*
                                  .-%#:.              .-%%*++++*%@=..                        .:-. .+%**%%+.                                    .+
                                     .:##-.               :*@#*+++*#@*:.                 ..-:      .=@:.                                         
                                         :#%-.               .+%%*++++#@#-.           .=%#.          :@:                                         
                                            .*%=.               .-#@#*+++*%%=.     .-%%*+*%.          .%-                                        
                                               .+%+.               ..+@#*+++*%%+.-%%*+++++*@-          .*+.                                      
                                                  .=%*.                .-#%*+++*%#++++*%@#++%+.         .=#.                                     
                                                     .-%#:                .:*@#+#**#@*-.##+++##.         .-%.                                    
                                                        .-%#:                 .=@%-.    ##++++*%.          :@:                                   
                                                           .:#%:                        *#+++++*@:          .%=                                  
                                                              .:#@-                     *#++++++*@=          .**.                                
                                                             .-%%*#                     *#++++++++%#.         .=#.                               
