                                                                              .*@=           .=@*.                      .%%:    .*@-.            
                                                                          ..+@=                 .-@*..                     .#@:...=@*.           
                                                                       ..+@=                       .-%#:---*=..#%#-++....    .:%@+.              
                                                                    ..+%=.                            .:%%*****=*+++*%#*@-**#%-.                 
                                                                  :+%=.                                  .:#%+*+**+**=+**%#.                     
                                                               :*%-.                                        .:*@*+*+*#%+.                     .:*
                                                            :*%-.                                               .+@#-.                     .:#@#+
                                        .=*.             :*%-.                                                                          .-#%*++++
                                        *=%.            .@%-.                                                                        .=%%*++++*%#
                                     ..=#+%.             #**%%=.                                                                  .+@#*++++*%#-. 
                                     *++=*@.             *#+++*#@*.                                                            .*@#*++++*@#:.    
                                  .**=++=#%.             +@*+++++*#@#:                                                          .-%%**@#:.       
                             .. .+#++=*+#@*@+.            .:*@#++++++*%%-                                                          .:%%:         
                    ...   .#%#%%#++*+#@=.  ..=@*.            ..=@%*+++++*%@=.                                                         .:#%:.-.:=:
                   .#=%%%**+=*=+*=#@=.        ..-@#.            ..:%@*+++++*#@*.                                                         ..#@*=*+
                   .*=+*+=*=+*=#@=.               .:%%.              .*@#++++++*@#.                                                          .#@*
                    *++*=++=#@=.                      :#%-..            .-%%*+++++*@%:.                                                         .
                    ==++=#@=.                            .#@-..             .#@#*++++*%@=.                                                   .-@%
                    -+#%=.                                  .*@=..             .+%%*+++++#@+..                                           ..=@%*++
                    -@.                                        .+@+..              -#@#*++++#@*:.                                     .:*@#*+++*#
                    .@:                                           .=%+..              :*@#*++++*%#-.                               ..+@#++++*%%+.
                    .#-                                              .=%*:.              .=%%*++++*%%=.                        ..::. .##*#@#-.   
                     :*                                                 .-##:.              .:*%#*+++*#@+..                 .:-.      .+%..      
                     .%.                                                   .-##-.              ..+%%*+++*#@*:.           .+@*.          -%.      
                     .#-                                                      .:*%-.               .-#%#++++*%#-.     .+@#*+#%.          :%:     
                      =*                                                         .:*%=.               .:*@#*+++*%%=.+@#*+++++*@:          .%-    
                      .%                                                            ..+%+.               ..=@%*+++*%*++++*%@*+*%-.         .#+   
                      .#.                                                              ..=@*.                .:#@#+%+*%@=..@*+++%+           +#  
                       =*                                                                 ..-@#.                ..=@*..   .@*++++##           -@.
                       :@.                                                                     -@#.                       .@*+++++#@.          .@
                       .@:                                                                        :%%:                    .@*++++++*@-          .
.     .. .. ..         .*=                                                                     ..+@%%*                    .%*++++++++%=.         
#%-.####*#*%*%=%%+:+-:%#:.                                                                  .:*@#+++#*                    .%*+++++++++%*.        
  .*@#***+***++*+**@*.                                                                   .:#@#++++*#@*                    .%*++++++++++#%.       
     .+@*+**+++#%+.                                                                   .-%%*++++*#@*.                      .%*+++++++++++*@:      
        .=%%%%=.                                                                   .=@%*++++*%%+.                         .%#++++++++++++*@=     
           .                      .-#@@%%@@@%%%##**++===--:::.....             ..+@#*++++*%%=.                            .%#++++++++++++++%*.   
                               .=%#==+%++++++++++++++++++*****#####%%%%%@@%%%%#@#*++++*%#-.                               .-#%*+++++++++++++##.  
%#:.                     :  :*@*=====+@%####***+++++++++++++++++++++++++++++++*#+++#@*:.                                     .:*@#+++++++++++*%. 
++*%%-.            .:.:-.-##+=====+%#-. .....:::--==+**#%%@@@@%%%%###****+++++*##@+..                                           .:+@#*++++++++*@-
#++++*%%-.        .--.:#*+=====#@+:.                             ......:::--==+=.                                                  ..=@%*+++++++%
.=@%*+++*%@=.     .:%*===*+==%-.                                                                                                      ..-@%*++++*
  ..=@%*+++*#@+..#+=+=*==+===%.                                                                                                 :++      ..-@@@@-
      .-@%*+++*@+===+===*+===%.                                                                                                .*##%%*=#+%@@%:.  
