                                                                   .#=+=#-                      .%#@*.                 .*@=.                     
                                                                  .%*++*%=.                     .@%:.                     .+@+..                 
                                                                 .+*+=#++*-                     .%-.%%:.                     .=@*..              
                                                                .*#==*#*==**.                   .@-   :%#:.                     .-%#:.           
                                                               -#+++%%+%%++**.                  .*%-.   .:%*:.                     .:#%-.        
                                                             .=*+%#-.   .-#%%.                     .+%=.   .-%*:.                     .:*%=.     
                                                            .:@#-.         .:##-.                     .+%+.   .=%*.                      ..+@=.  
                                                         .-##-.               .:*%-.                     .+%+.  :*@-                         .=%+
                                                      .-##-.                     .:*%=.=:++-.:##+-*.        .*@#-.                              .
                                                   .-##:.                           ..+@#***#+++=++##*#+=*+%*:.                                  
                                                 -%#:.                                 ..=@#+*#++***++*#%=.                                      
                                              -%#:.                                       ..=@#+=*++%%-.                     .-#@@#:.            
                                           -%#:.                                             ..-%@*:.                     .-%%*+**+*%%-.         
                       .*-              -%#:.                                                                          .+@%*++++#*++++*%@=.      
                      :#=-            .*@+.                                                                         .*@#*++++*@*.*@#+++++*#@*.   
                     .#=+=             :%+#@#.                                                                   .#@#+++++*@*.     .=@%*+++++#@#.
                   +*++=+=             .@++++*@%:.                                                            :%@*++++*#@*.           .-%@*+++++*
                 :%+=+++*=              %#*+++++*%@-.                                                          .*@**#@*.                 .:#@#*%@
            ...:*#+++*+#%%#:.            .+%%*+++++*%@+.                                                          .*%=.                      :@@=
  ..:.  .-++++#*+*++#%-.  .:##-.            .-#@#*+++++#@*:.                                                         .+%=..:.--:*=           -@+*
  *++#+##*==*=+++%%-.        .:*%-.            ..*@#*+++++#@#-.                                                         .+@#*+*=+*           =@++
  =**+*=+*=+++%#-.              ..*%=.             .=%%*+++++*%%=.                                                         .=%#+=*            :*%
  :#+++=+++%#-.                    ..+%+.             .:*@#*++++*%%+.                                                         .=@*               
  .%++=+%#-.                          ..=%*.              .+%%*++++*#%*:.                                                   .+@#*%.              
  .#+%#:.                                 .=%*:              .-#%#++++**%#-.                                             :*@#*++*@.              
   #-.                                       .-%#:              .:*@#*++++*%%=.                                       -#%*++++*#@+.              
   -*                                           .:#%:              ..=%%*++++*#@+.                                ..%%*++++*%%-.                 
   :@.                                             .:#%-               .:#@#++++*#@#.                         ..=.. -@**%@+..                    
   .@-                                                ..*@=.              ..=@%*++++*@%:.                  .=:..     .@=..                       
    ++                                                    .+@+.                :%@*++++*%@-.            :%@:          .%-                        
    .#                                                       .=@+..               .*@#*+++*%@+..    .:#@*++@-.         .#+.                      
     %.                                                         .=@*..                =@%*++++#@*.:#@*++++++%+.          =#.                     
     *+.                                                           .-%#:.                :#@#*+++*%++++*#@%++##.          :@.                    
     -%.                                                              .-##:.                .+@#**%**%%=.:%+++*@:          .%:.                  
     .%.                                                                 .:#%-.                .-%%+.    :%++++*@-          .#-.                 
      *-                                                                    .:*%=.                       :%++++++%=.         .**.                
      -#                                                                       ..*@=.                    :%+++++++%*.          =#.               
      :@.                                                                     .:*@#@.                    .%++++++++#%.          :%:              
.-+.+%+..                                                                  .-#%*+++@:                    .%+++++++++*@:          .%-             
*%%=.                                                                   .=%%*++++*%@:                    .%+++++++++++%=.         .#=            
-.                                                                   .+@#*++++*%%-.                      .%++++++++++++%*.         .**           
                                                                  .*@#*++++*@%-.                         .%+++++++++++++#%.          =%.         
                 .=@@%@@@@@@@%%%#*+==-:....                    :#@**++++*@#:.                            .%++++++++++++++*@.          .@:        
              .*@*==#++++++++++++++++*********###%%%@@@@@@@@@@@*+++++#@*..                               .+@#+++++++++++++*@-         ..%:       
