                                                                                   *#######%######**=*#.                                         
                                                                                   *#######%#####@*=*=%..                                        
                                                                                   *#######@###%+-%%+*==*..                                      
                                                                                   ########@#:.    .:#@+*#:                                      
                                                      .:**:.                       #####%+..          ..*@-.                                     
                                                      *==+++                       #%#-.                 ..+%+.                                  
                                                    .@=++**#-                      +@%-.                     .=%*:                               
                                                   .+**+**+++.                     +* :*#-.                     .-%*:.                     ..... 
                                                  :*++++#++=+#.                    **    :##:.                     .-##-.                .*%@##%#
                                                 :%*=*@+.-%%++@.                   .+@+.   .-##:                      .:*%=.           .+%##@####
                                                =**@+..    .-#@=.                     .+@+.   .-%*:                      .:+%=.       .#####@####
                                              .=@+..          .:#%-.                     .=@+.   .-%*.                      ..+%+.   .######@####
                                           .+@+..                .:*%=.                     .=@*..=%#:                         ..=%*.-%#####%####
                                        .+@+..                      ..*@=*#*#%=-#*#%%+ ..     .*@+..                               .-@######%####
                                     .+@+..                            ..+@##***==#*++**+#%#@@-.                                    .%######%####
                                  .+@=.                                    .=@#**++#+**=+@%.                       .                .%######%%###
                               .+@=.                                          .-%%=++#@+.                     ..+@#%@@-..           .%#######%###
                            .+@=.                                                .:#-                      .:*@#+++#++*%@=..        .%#######%###
         .#*             .+%=.                                                                          .:#@*++++*%%*++++*%@+..     .%#######%%*.
        .%+*             .@@+:.                                                                      .-%%*++++*%%= .+@#*+++++#@*:.  .%#####%+.   
     .:+#*+*             .%++#@*:.                                                                .=%%*++++*%%=.      .=%%*+++++#@#:.%#%#-.      
     :#*==**              #*++++*%#-.                                                           .@%*++++*%%=.            .-#%#+++++#@#:.         
   :#++++++*.             =@#*+++++*%%=.                                                          :*@#%%-.                  .:*%#@*:.            
.=#*++++*%*-##-.            .=%%*+++++*#%+.                                                          .+%+.                     .@%%+.            
#*+*=*%+.    .:*%-.            .:*@#*++++*#%#:.                                                         .=%+.*=+#**%.          .@*+*#%*.         
*=*%+.          .:*%=.            ..=%%*+++++*%%-.                                                         .=%#=++=#.          .@#++++*#@*.      
@+.                 .+%+.             .-%@*+++++*%%=.                                                         .-%%=#.           .:*@#++++*#@#:   
.                      .=@*.             ..+@#*++++*#@*.                                                         :%@.              ..+@#+++++*@%:
                          .-@#.             ..-@%*+++++*@#..                                                  :@@*+@.                 ..=@#+++++*
                             .:@%.               .%@#+++++*@@-.                                           .-@%*++++@:                     .=@#+++
                                .:%%:.              .+@%*++++*%@=..                                   ..+@#+++++*@@-                         .=@%
                                    .#%:.              .:%@**+++*#@+..                             ..:%#++++*#@*.                               .
                                       .*%-.               .*@#*++++#@#:.                      ..--.  .*%*@%-.                                   
                                          .*%=.               .=%%*++++*%%-.                ..-.        =%.                                      
                                             .+%+.                -#@#*+++*%@=.          .=@@#.          :%.                                     
                                                .=%+:                .+@%*+++*#@+:    .=@%*++#%.          .%:                                    
                                                   .=%*:                .=#%*++++#@*=@%*++++++*%:          .%=                                   
                                                      .-##:.               .:*@#*+++%++++*%%@++*%-.         .**                                  
                                                         .:##-.                .=%%*%*%%+:..%++++%*.          =%.                                
                                                            .:*%=.                .:+:.    .%+++++#%.          :%.                               
                                                               ..+%+.                       %++++++*@:          .%:                              
                                                                  ..#@:                     %*++++++*%-          .%=                             
                                                                .=@%*%=                     %*++++++++%+          .**.                           
                                                             .*@#*+++#*                     %*+++++++++##          .=%.                          
