                                                                              .#@-                 .=@*.                      .%%:  .+@+         
                                                                          ..*@-                       .-@#.-:=*-..@%#:*+....    .:@@=.           
                                                                       ..*@-                             .-%%*****=*=*=#%#*%-*+%%:               
                                                                    .:*%-                                   .:%%+*******=*+*@*.                  
                                                                 .:*%-                                          :#@*=*++#%=.                     
                                                              .:##-.                                               :*@#-.                     .-#
                                           .=+             .:##-.                                                                          .=%%*+
                                          .*=*             :@#-.                                                                        .+%%*++++
                                        .:+*+#              %**%%=.                                                                  :*@#*++++*@#
                                       .#++=*#.             #*+++*%@+.                                                            .#@#+++++*@#:. 
                                     .#*=+++*#.             *@*+++++*#@*:                                                          .-%%**@#:.    
                                .. .*#+++*+#@*%+.            .:#@#+++++**@#:                                                          .-%#:      
                       .:.   :######=+++#@=.  ..=@*.            ..+@%*+++++*%%=                                                          .:%%:.=.
                      :#=%%#**==*=++=#@-.        ..=@*.            ..-%@*+++++*#@+.                                                         .:%@*
                      .#=+*==*=+*=#@-.              ..-@#.             ..*@#+++++*#@#.                                                         .:
                       **+*=++=#@-.                      :@%.              .=@%*+++++*@%.                                                        
                       +=*+=#%-.                            :#%-..             :#@**++++*%@-.                                                   .
                       ==%%-.                                  .#@-..             .*@#*++++*%@=..                                            .+@%
                       =%.                                        .*@=..             .-%%*+++++#@*:.                                     .:*@#+++
                       :@.                                           .+%+..              :*@#*++++#@#-.                               ..*@*++++*%
                       .%-                                              .=%+:.              .+%%*++++*%%=.                        ..::. .%#*#@#:.
                        =+                                                 .=%*:.              .-#%#*+++*%%+..                 .:-.      .*#.    
                        .%.                                                   .-##:.              .:+%#*+++*#@*:.           :*@+           =%.   
                         %:                                                      .:##-.               .=%%*+++*#%#-.     .*@#++##.          :%.  
                         **                                                         .:*%-.               .:*@#*+++*%%=.*@#*+++++*%.          :%: 
                         -%                                                            .:*%=.               ..=@%*+++*%*++++#@@*+*%:          .%=
                         .%.                                                              ..+%+.                .-%@#+%+*%@=..@*++*@=          .*
                          +=                                                                 ..=@*.                ..+@*..   .@*++++%*          .
                          -%.                                                                   ..-@#.                       .@*+++++#@.         
                          .@:                                                                        :@%.                    .@*++++++*@:        
@#..     .. .. ..         .%-                                                                     ..*@#%=                    .@*++++++++@-.      
  :%%:.%#%%*%*%*%=@%=:+:-%#.                                                                   .:#@#+++#*                    .@*+++++++++%+.     
     :#@****++**++*+**@*.                                                                   .:%@*++++*#@+                    .@*++++++++++##.    
        .*@*+**+++#%=.                                                                   .-@%*++++*#@+.                      .@*+++++++++++*@:   
           .+%#%%-                                                                    .=@%*++++*%%=.                         .@*++++++++++++*@-  
                                     .-%@%%%@@@@%%##**++==---:::.....              :+@#*++++*%%-.                            .@*++++++++++++++%=.
@+.                               .+%#==+#++++++++++++++++++*****####%%%%%%@@@%%%%@#+++++#%#-.                               .-%%*+++++++++++++%*
++#@*:                      :  :*@*=====+@####*****++++++++++++++++++++++++++++++#*+++#@*:                                      .-#%#+++++++++++#
#++++*%#:             :..-:.=##======*%*:. .....::---=++**#%%@@@@%%%%###****+++++#*%@=.                                            .:*@#+++++++++
:*@#++++*%%-         .--.-#++=====#@+.                               ....:::---==+-.                                                  ..+@#*+++++
  ..+@#*+++*%%=.     .-#+===*===@-.                                                                                                      ..=@%*++
     ..=@%*+++*%@=.:#+=+=+==+===%.                                                                                                .:*+       .-@%
        ..=@%*+++*@====+===*+===%.                                                                                                .%*##%*+#*@@%#:
           ..-@%**@====*+===*===%.                                                                                                .#=*++*=*@*..  
