                                                                              :@#.                                    .+@*+*++#*+*+=%@-.         
                                                                         ..-@#.                                          .=@%=+=*@#..            
                                                                      ..-@#.                                                .=@*.                
                                                    .*#             .-%*.                                                                        
                                                   .#=*             .@@=.                                                                       .
                                                 .-**+#.             #*+#@*:.                                                                .-#%
                                                .#++=*#.             *#++++#%#-.                                                           .%@*++
                                              .#+=+++*#.             =@#*+++++*%%=.                                                          :*@#
                                         .. :**++++*%#=##:.           ..=%%*+++++*#%+.                                                          :
                                .+:  .:*#**#*+*+*%#-.   .-##-.            .-#%#+++++*#@*..                                                       
                               :#=#*+*++++=*++%#:.         .:*%-.            .:+@%*++++**%#:.                                                    
                               .%=*++++++*+%#:.               .:*%=.             .-%%*+++++*%%-.                                                 
                                ***+=*=+%#:.                     ..+@+.             .:#@#+++++*%@+.                                              
                                +++++@#:.                           ..=@+.             ..+@%*++++*#@*.                                           
                                -+@#..                                  .-@*.             ..:%@*+++++*@%:                                        
                                -%.                                        .:@#.               .*@#+++++*@@-                                     
*@@%.                           .@:                                            :%#:.              .=%%*++++*%@=..                             ...
#@##%:                          .%=                                               .#%:.               :#@#*++++#@*..                       ..-.  
#@###*                           -*                                                  .*%-.               .+%%*++++*@#:.                ..-:.     
#@###%.                          .%.                                                    .*%=.               .-%%**+++*%%-.          .-%@#.       
#@###%.                           #-                                                       .+%+.                :*@#*+++*%%=.    .-#%*++#@.      
#@###%:                           +*.                                                         .=%+:                .=%%*+++*#@*-#%*++++++*@:     
#@###%:                           :%.                                                            .=%*:                .-#%#*+++%++++*#@@*+*%=.   
#@###%:                           .%:                                                               .-##:                 .+%%*%*#@#-..%*+++%*.  
#%###%:                            ++                                                                  .-##-                 .-*=.    .%*++++#%. 
#%###%-                            :%.                                                                    .:*%-.                      .%*+++++*@:
#%%%@##%-                          .@:                                                                       .:*%-                    .%*++++++*@
%@+..  ..*@=.        .   .         .#=                                                                     .:%@*%+                    .%*++++++++
..        ..+@+.#%%+%@=*=#*#*++%=*@=..                                                                  .-@%*+++##                    .%*++++++++
              .-@%=*+*+*=+*=*+@@-.                                                                   .=@%+++++*%@-                    .%*++++++++
@*..             .:%%=***++@#:.                                                                  ..*@#+++++*@@-                       .%*++++++++
++#@#:.              :%@@*.                      .....                                        .:#@#+++++*@%:                          .%*++++++++
#*+++*@#:.                                   ..+@%##%%%@@@@@@@@%%#*++=--::::........       .:%@*++++*#@#.                             .%#++++++++
.*@#*+++*%%-.                             .:*@*==+#++++++++++++++++++++++++****###%%%%@@@@@%*++++*#@+.                                 .*@#*+++++
   .+%#*+++*%%-.                    .- .-%%+=====*@%%%####*******+++++++++++++++++++++++++**++*%%=.                                       .+@#*++
      .+%#*+++*%%=.            :..:-.+#*======*@+.       ....:--=++**##%%%%%%%%%####*******#%%-.                                             .=%%
         .=%%*+++*#@+.         --.=#++====+#%=.                                    ...::--=:.                                                   .
            .=%%*+++*#@*..    .=#+===*===@-.                                                                                                     
               .-#%*+++*#@#:=*+=+++==+===@.                                                                                                .+**  
                  .:#@*+++*@+===+==+++===@.                                                                                                .%+***
                     .:*@#*@+===*===+*===@.                                                                                                .%*+=+
                        ..*@+===*+===++==@.                                                                                                .%*++%
                          .%+===+=*==+===@.                                                                                                .#@%:.
                          .#*===+==*=+===@.                                                                                                .@%@-.
