                                                                              :%%:                            .#@*#**+#**===#=@%%..:-@%.         
                                                                          .:%%:                                  .*@*+*+*+=+*++#+#@+.            
                                                                       .:%%:                                        .+@*=***++%%-.               
                                                                    .:%#:                                              .+@%@#:.                  
                                                 .-.             .-%#:                                                                           
                                               .+*@.            -@+..                                                                         .+@
                                              ..#=%.            .@##@+..                                                                  .:*@#++
                                            .#*#++%.            .##++*#@*:.                                                             -#%*++++*
                                           -#*=*+*%.             *%++++++*%#-.                                                          :*%#++#@*
                                     .. .:***+*++#@#:             :+@%*+++++*%%=.                                                         .:*@+. 
                             ..   .:---+#*+**+%%-. .-%#:             .-%%*+++++*#@*.                                                         .:*%
                           .#+%==#**==*=+++%%-.       .:#%-.            .:*@#*++++*#@#:                                                         .
                            #+=+*=++=*+=%%:.             .:*%-.            ..=@%*+++++*%%-                                                       
                            **=++=*==%%:.                   ..*@=.             .:%@*+++++*%@=.                                                   
                            *+=*==@%:.                         ..+@+.             ..*@#+++++*#@+.                                                
                            =+=%%.                                 .=@+.              .-@%*+++++*@#.                                             
                            -%.                                       .-%*..              .#@#*++++*@%:.                                       .:
.                           .%.                                          .-%#:.              .+@%*++++*%@=..                               ..-%%*
%.                           #:                                             .:#%-.              .-%@**+++*%@+..                         ..-: .%*+
#*.                          =*                                                .:#%-.              ..*@#*++++#@*:.                   .:-.     .%@
#@.                          :@.                                                   :*%=..              .=%%*++++*%#-.            .:*-           *
#%-                          .@-                                                      .+%=..              .:#%#*+++*%%=..     .:#%**%+           
#%-                           ++                                                         .+%+..               .+%%*+++*#@+..:*%#+++++#%.         
#%-                           .#.                                                           .=%*:.               .-#%*+++*#@#+++++#%*+*%:        
#%-                            %:                                                              .-%#:.               .:*@#*+@*+*%%=:@*++*%:       
#%-                            *+                                                                 .-##:.               ..=%@@*:.  .@*+++*@=      
#%-                            -%.                                                                   .:#%-.                .      .@*+++++%*     
#@%:.                          .%.                                                                      ..*@=.                    .@*++++++#@.   
....#@-.                        *-                                                                       .#@%=                    .%*+++++++*@:  
      .*@=. --*%:*@#%%.=*: ...=@*.                                                                    .%@*++#*                    .%*+++++++++@- 
         .+@%#**+=**+*=**#*#@=.                                                                   .-@%*++++*##                    .%*++++++++++%*
            .=@%+*+#++*+@%-                                                                    .=@%*++++*%@=.                     .%*+++++++++++#
..             .-%%*+@#:                                                                   ..+@#+++++*%%-                         .%*++++++++++++
#@#:.             .:.                      .=%@%%##*++=---::::.......                   .:*@#+++++*@#-                             #*++++++++++++
+++*@#-.                                :+@#=+#++++++++++++*****###%%%%%@@@@@%%##**+===#@*++++*#@*:                                +@#*++++++++++
@#*+++*%%-.                     ..  .:*%*=====%****+++++++++++++++++++++++++++++++++++##+++*#@*.                                     .*@#*+++++++
 .+%#*+++*%%=.             .. .:---##======*%*-::-==++**##%%%@@%%%%####*****++++++++++##*%%=.                                           .+%%*++++
    .=%%*+++*%%+.         .:=:.-##======#%+.                         ....:--==++**##%%@%=.                                                 .=%%*+
       .-%%*+++*#%*.       .+#+==*===##-.                                                                                                     .-#
          .-%%*+++*#@#:  =#++==+=*===%.                                                                                                 ..:      
             .:#@*++++*@+==++===+*===%.                                                                                                 **%=*-.#*
                .:#@#++@====++===*===%.                                                                                                 +==*++*=#
                   ..#@@====+=*==*===%.                                                                                                 +=++=#@=.
                      .*+===+==+**===%.                                                                                                 +=%@-.   
