                                                                            .%=*@+     .#@%.                     .:@#.    .#@:.                  
                                                                          ..+@+.          .*@=..                    .:%#..   .%%:.               
                                                                        .=@+.                .+@+..                    .:%#:...-@#.              
                                                                     .+@+.                      .=%+.:::=-..#%+:==        .-@@*.                 
                                                                  .+%+.                            .=%#*+*+*+*=+=**##@-=+*%=.                    
                                                               .+%=.                                  .-#%+*+**+**++**%#:.                       
                                                            :+%=.                                        .:#%*+*+*#%+.                     ..+@@%
                                                         :*%=.                                              .:*@%=.                     .:*@#**@+
                                     .-+.             :*%=.                                                                          .-#%#++++*%+
                                     *+%.            .@#:.                                                                        .=%%*++++*%%-=%
                                   .=#=%.             %**%%-.                                                                  .+%%*++++*%%-.    
                                  *+*=*@.             ##+++*%%+.                                                            .*@#*++++*%%-.       
                               .+*==*=#@.             *%*+++++*#@*.                                                          .=@%**%%-.          
                          .. .=#+*=*+*@#@=.            .:%@*+++++**@#:                                                          .-@#.            
                  ..   .***#%#++*+*@+.. ..+@+.            ..*@#*+++++*@@-                                                          .-%#..:..:.-%.
                .#=%#%#*+=++=*=*@+.         .=@*.              -@@*+++++*%@=                                                          .:%@*=*==%:
                .#=+++=*=+*=*@+.               .-@*..             :#@#*+++++#@*..                                                        .:%@*=#:
                 **=*=++=*@+.                     .-%#:.             .+@%*+++++*@#:.                                                         :%@:
                 +=++=*@+.                            :#%-.             .-#%**++++*%%-.                                                   .-%@*@-
                 =+#%+.                                  :#%-.              .*@#*++++*%%=.                                            ..=@%*+++@-
                 -@.                                        :*%=.              .=%%*++++*#@+:                                      ..+@#*++++*%%:
                 .@.                                           .+%=.               :*@#*++++#@*:.                               ..+@#*+++*#%*:   
                 .#-                                              .+%+..              .+@%*++++*%#-.                         .::...%#*#%#-.      
                  -*                                                 .=%*..              .-#%#++++*%%+.                  .:-:.     .*%:.         
                  .%.                                                   .-%*:.              .:*@#*+++*#@*.            .+@+           =%.         
                  .%-                                                      .-##:.               .=%%*+++*#@#:.     .+@#*+##.          :%.        
                  .+*                                                         .:#%-.               .:#@#++++*%%-.=@#*+++++*@.          .%:       
                   :%                                                            ..*@-.               ..=@%*+++*%*++++*%@*+*@:          .%=      
                   .#.                                                              ..+@=.               ..:%@*+%++%@*..@*++*%=          .**     
                    ++                                                                  .+@+.                 .*@%..   .@*++++%*           =@.   
                    -@.                                                                    .=@*..                      .@*+++++#%.          .@.  
                    .@:                                                                        -@*.                    .@*++++++*@:          .%:.
   .. .. ..         .#=                                                                     ..=@%%+                    .@*++++++++@-.         .%=
.*+#%+##%#%-#%=:=::#%-.                                                                  ..+@#*++#*                    .@*+++++++++%+.          *
#@***++**+++*+**%#:.                                                                  .:*@#++++**@+                    .@*++++++++++##.          
  :*@*++*+++*%+..                                                                  .-#@#++++*#@*:.                     .@*+++++++++++*@:         
     .+@##%=.                                                                   .=%%*++++*#@+..                        .@*++++++++++++*@-        
        ..                     .:#@@%@@%%%###**++==---::.....               ..=@%*++++*%%=..                           .@#++++++++++++++%+.      
                            .=%#+=+#++++++++++++++++*******#####%%%%@%%%%%##@#*++++*%%-.                               .-%%*+++++++++++++##.     
                     .:  .+@*======@###****++++++++++++++++++++++++++++++++#*+++#@#:.                                     .:#@*+++++++++++#%.    
@#:             .:.:-:-##+=====+%%-......:::--==+*#%%@@@@@@%%%###***+++++++###@*:.                                           .:*@#+++++++++*@:   
++*%%:         .--..**+=====*@*:.                           .......::::-=+**+..                                                 ..*@#++++++++@+  
#++++*%@-       .%*===++==@=..                                                                                                     ..+@%*++++*@+.
.+@#++++*%@-..**=+=++=+===%                                                                                                  .==      ..-@%%@-.  
