                                                                                     .%######%#####%+**=*.                                       
                                                                                     .%######%####%*@##*+*#.                                     
                                                                                     :%######%%#:.   .=@#***+                                    
                                                         .:-.                        -%####%+..         .-%@:.                                   
                                                        -*=+=#.                      -%%%-.                .:##:.                                
                                                       -#+++*#-.                     :@#:.                    ..*%=.                             
                                                      .#+++++*%.                     .#.-%*:.                     .+%+.                          
                                                    .=#+=+*++=+#=.                   .#   .=%*.                      .=%*:                 .:#@##
                                                    +++=#%++%#++#:                   .*#-.   .=%+.                      .-%*:             .###%##
                                                  .#+#@+..   .=%%=                     .:*%-.   .=%+.                      .-##-.        -%###%##
                                                 .+@=..         .-%*.                     .:*%=.   .+%=.                      .:*%-.    -%####%##
                                              .+@=..               .-%#:                     ..*%=. .=@*.                        .:+%=..######%##
                                           .+@=..                     .:#%::=:#+:.*##=+*.       .:%@=..                             ..=@%######%#
                                        .*@=..                           ..#@**+**=++=+*%**%=*##%-.                                   .########%#
                                     .+@=..                                 ..*@*+*+*+**=*+#@#..                                      .########%#
                                  .*@=                                          .*@*+=++#@+.                      .+@@@*.             .########%#
                              ..*@=                                                .+@%-.                     ..#@#+*@++*@%:.         .########@#
           .-#.             .*%-.                                                                          .:#@*++++*@+++++*%%-.      .########@#
           ++%.            .%%-.                                                                        .-%%*++++*%%-:#@**++++*%@=.   .#######%+.
        .:-#=%.             *#*%@=.                                                                  .=@%*++++*%%-      .*@#*++++*%@+..###%#-.   
        *+*=+%:             +%++++#@*:.                                                           .+@#*++++*%%-            .+%%*+++++#@@*..      
     .+#=+*+*%:             -@#*+++++#%#-.                                                         .-#%**%#-                  .-#%*#@*:.         
.. .=#*++++*%*%*:            .:*@#*+++++*%%=.                                                         .:##-.                      *@#-.          
***#++*+*%+.   .-%*:             .=%%*+++++*#%+.                                                         .:*%-.-:.+--#:           *#+*%%=.       
++++=*%+.         .-##:.            .:*@#+++++*#@*..                                                        .:*@#+++=*-           ##++++*%%=.    
*=#@=.               .:#%-.             .+@%*++++**%#:.                                                         :+@#=*-           .-%%*++++*#%+. 
@=.                     .:*%-.             .-%@*+++++*%%-.                                                         .*@-              .:#@*++++*#@
                            .+@=.             ..*@#*++++*#@+.                                                    -@%*%=                 ..#@*++++
                               .=@+.             ..-@@*+++++#@#.                                             .=@%*+++%=                    ..#@*+
                                  .=@*.               .#@#+++++*@%:                                       .*@#+++++*@@:                        .*
                                     .-@*..              .+@%*++++*%@-..                              ..+@*++++*%@*.                             
                                        .-%#:.              .-%%*++++*%@+..                       ..--. .*%**@%-.                                
                                            :##:.               .#@#*++++#@*:.                 .:=.      .=%.                                    
                                               .#%-.               .+%%*++++*@#:.           .=@*.          -@:                                   
                                                  .*%=.               .-#@#*+++*%%-.     .=@%*+#%.          .%-                                  
                                                     .*%=.               ..+@#*+++*%%=:=@%*+++++*@-          .#=.                                
                                                        .+%+.                .=%%*++++%*++++*%@*++%=.         .**.                               
                                                           .=%*:                .:*@#*%**%@*:.%#+++%*.          =%.                              
                                                              .-##:                 .=%*-.   .%#++++#%.          :@:                             
                                                                 .:##-                       .%#+++++*@:          .%-.                           
                                                                    .:*%-                    .%#++++++*@=          .#=.                          
                                                                   .+@%#*                    .%#++++++++%*.         .+*                          
                                                                .*@#*++*#                    .##+++++++++#%.          =%.                        
                                                             .#@*+++++*@#                    .##++++++++++*@.          :@:                       
