                                                                                 =#######%######++%-.                                            
                                                                                 =#######%#####%+=**#.                                           
                                                                                 =#######%#####%++=*%=..                                         
                                                                                 +#######%##%=..:%%+*+%=.                                        
                                                      ..                         +######%#:.       :#%+%.                                        
                                                    -*##*:                       +##%%+..             .*%=.                                      
                                                  ..*+*++=                       *@-.                    .+%+.                                   
                                                  .#++*++**.                     =#*%-.                     .=%*:                                
                                                 .%*+**+=*#-.                    =* .:##-.                     .-##:                    .:+**-.  
                                               .**=*+*@#+++#=                    =#.   .:##:.                     .-##-.              .=%#@###%*.
                                              .=*+*@*:..-%%+#.                   ..+%+.   .-##.                      .:*%=.          .%###@#####%
                                              =*@*..      .:#%:.                    ..=%+.   .-%*.                      ..+%=.      .%####@#####%
                                           .=@+..            .:#%-.                    ..=@+.   .-%+.                       .=@+.  .######%#####%
                                        .=@+..                  ..*@-.        ::.         ..=@*=@#:.                           .-@*=######%#####%
                                     .=@+..                        ..*@@*@#+%%**=*=*.=*-.  .*@+..                                 .@######%#####%
                                  .=@+.                                .+@#+*+*=+**=**+**%@:.                                     .@######%%####%
                               .=@+.                                      .=@#=+*+=*++@#.                     ..=#:.              .@######%%####%
                            .+@+.                                            .-%#+#@+.                     ..+@%*%*%%-.           .@######%%####%
        ...              .+@+.                                                  ...                     .:*@#+++*%+++*%@=.        :@######%%##%#:
      .-*%.            -@+.                                                                          .:#@#++++*#%@#*++++*#@+.     :@######%%*.   
      :#+#.            .@%@+:.                                                                    .-%%*++++*%%=.  .+%#*+++++#@*:. :@###%#=.      
   .*##++%.            .@*++#%#:.                                                              .=%%*++++*%%=.        .=%%*+++++#%#=@%#-.         
  .+*+=++%.            .%#+++++*%%=.                                                          .*@#*++*%%=.              .-#@#+++*%#-.            
.=*+++++*%:.            .+%%*+++++*%%+.                                                         .:*@@=.                     :+@%:.               
**+++*%*:.-##-.            .-%%*+++++*#@*..                                                        ..+%+.       ..           .@*#%+.             
+**%*:.     .:*%-.            .:*@#*++++*#@#:.                                                        ..+@+%#%**%#           .@*++*#@*.          
@*..           .:*%=.             .=@%*+++++*%%-.                                                        ..=@#=*+#           .*@#++++*#@*.       
.                 ..+@+.             .:#@#+++++*%@+.                                                        ..-@%*             ..*@#++++**@#.    
                     ..=@*.             ..+@%*++++*#@#.                                                       .#@@                ..+@#+++++*@%. 
                          -@#.              .-@@*+++++*@%:                                                 :@@*++%.                   .+@#+++++*@
                             -@#..              .#@#*++++*@@-..                                       ..=@%*++++*@.                      .=@%*+++
                                :%#:.              .=@%*++++*%@=..                                 ..+@#++++**@%:                            =@%*
                                   :#%-.               :%@**++++#@+..                           ..-.+%+++*%@+.                                  =
                                      .#%-.               .*@#*++++#@#:.                    ..-:.    -@@#-.                                      
                                         .*%=.               .=%%*++++*%%-.              .-..         .%-                                        
                                            .+%+.               .:#@#*+++*%%=.        .=%%*@:          .#=.                                      
                                               .=%*:                .+%%*+++*#@+:  .=%%*++++@=.         .*+.                                     
                                                  .=%*:.               .-#%#++++#%%%*++++**++%+.         .+#.                                    
                                                     .-##-.                :+@%*++@*++#@#=@*++##.          -@:                                   
                                                        .:*%-.                .-%%@%%=.. .@*+++*@.          .%-                                  
                                                           .:*%=.                ...     .@*++++*@-          .#=.                                
                                                               .+@=.                     .@*++++++%+.         .**.                               
                                                                .-@@:                    .@*+++++++##.          =%                               
                                                             .=@%*+#=                    .@*++++++++*%.          :@:                             
