                                                                                          .%######%%%#.   .=@#+**#                               
                                                               ....                       .%#####@=.          -@@=.                              
                                                             .%=+=%:                      .%#%%:                 :%#:.                           
                                                            .##***#:.                     .@*..                     :#%-.                        
                                                            +#+=*=*#.                     .@-=%+..                     .#%-.                     
                                                          .+#==+**==#+                    .@:  .=%+..                     .+%+..                 
                                                         -#+++#%*@#++#=.                  .##-.   .+%+.                      .=%*:.             -
                                                       .-*=%%=.   .+@%*.                    .:##-.   .+%=.                      .-##:.        .##
                                                       :@%=.         .=%*..                    .:##-.   .+%=.                      .-##-.    .###
                                                    :*%=.               .-%*:.                    .:*%-.  .*@-                        .:*%=. +%##
                                                 .*%-.                     .-%#:.-.=-..:#*-.+.       .:#%%=.                             .:+%%###
                                              :#%-.                           .:#@**+**+++=++%#*#-:+=%#-.                                   -%###
                                           .#%-.                                 .:#@++***+***=**#@*:.                                      -####
                                        .#%-.                                       ..*@*++#+=%@=..                     .*@@*.              -####
                                     .#@:.                                             ..*@@%:.                      .%@*+#***@#.           -####
                 .-.              .#@:                                                                           .:@@*++++#*++++*@%.        =####
                .#+-            .%%-.                                                                         .=@%+++++*@%-%%*+++++*%%-.    =####
              ..#++-             -%*%@=..                                                                 ..+@#+++++*@#:.    .#@#*++++*%@=. =###%
             +*+*++-             .@+++*#@+..                                                            .*@#+++++*@#:.          .+@#*+++++#@#%+. 
           :*#=*+++-             .%*++++++#@*:.                                                         .-%%*+*@#:                 .=%%**#@*.    
      ....=*+++++#@%+..           .:*%#*+++++*%%-.                                                         .-##:.                     .=@#-.     
   :====#*++++#%=.  .=%*:.            .+%%*+++++*%%=.                                                         .:##-....::.+-           -%+*%%-.  
+*#*+=++++=#%=.        .-%*:.            .-#@#+++++*#@+.                                                         .:*@****=**           =%++++*%%=
*+++=++=#%=.              .-##:.            .:+@#*++++*#@*:.                                                        .:*%*+++           .-%%*++++*
+=++=#%=.                    .:##-.            ..=%%*+++++*%#-.                                                        .:*@+              .-%%*++
==%%-.                          .:*%=.             .:*@#+++++*%%=.                                                    .=%%##                 .-#@
%-.                                ..*%=.             ..=@%*++++*#@*.                                              .+@#*++*%.                   .
                                      ..=@+.              .:%@*++++**@#.                                        .#@#*++++#@#.                    
                                         ..-@*.              ..*@#*++++*%@-                                  .%@*++++*%@=..                      
                                              -@#.                -@%*++++*%@=.                          .=:  =@*+*@%.                           
                                                 :@#:.               :#@#*++++#@+..                  .:=.      .@+.                              
                                                    :%%:.               .+@%*++++#@#:.           ..*%.          .%..                             
                                                       .#%-.               .-%%**+++*@%-.     ..+@#+*@:.         .%=                             
.                                                         .*%=.                .*@#*+++*%%=..+@#+++++*@=.          **.                           
=                                                            .*%=..               .=%%*+++*%%++++**%#++%*.          =%.                          
#.                                                              .+%+..                -#@#**#+*%%*:-%+++#%.          :%.                         
%.                                                                 .=%*:.                .+@@*-.   -%++++*@:          :%:                        
#:                                                                    .-#*:.                       -%+++++*%-.         .%=                       
=*                                                                       .:##-.                    -%++++++*%+           **.                     
:@.                                                                      .*%#@.                    -%++++++++##.         .=%.                    
*:.                                                                   :#@#*+*@:                    -%+++++++++#@.         .:%.                   
                                                                  .:%%*+++++#@-                    -%++++++++++*@-          .%:                  
                                                               .-@%*++++*#@+..                     :%+++++++++++*%=.         .%+                 
                                                            .=@%*++++*%@=..                        :%+++++++++++++%*          .+#.               
