                                                                   ..                        :%#####@-.          :@@=                            
                                                                :#=+=%.                      :%#%#.                 :%%:.                        
                                                               .%#+**#:.                     .@*..                     .#%-.                     
                                                              .+*+=*=+#:                     .@:-%*..                     .*%=..                 
                                                             .+*==*#*==#+                    .@:  .=%+..                     .+%+..              
                                                            =#+++#%*@#++#=.                  .##-.   .=%+..                     .=%*:.           
                                                          .=*+%%-.   .+%%*.                    .:##-.   .+%+.                      .-##:.        
                                                         .:@#-.         .=%*:.                    .:*%-.   .+%=.                      .-##-.    .
                                                      .:##-.               .-%*:.                    .:*%=. ..*@:                        .:*%=. +
                                                    :##-.                     .-##:.-.==:.:#*=:+.       ..#@%=.                              .+@%
                                                 :##-.                           .:#@**+*#+++=++%#*#--*=%#:.                                   =%
                                              :##-.                                 .:*@*+***++**+**#@+..                                      =%
                                           :%%:.                                       ..*@*++*++%%-..                    ..#@@*.              =#
                                        :%%:.                                             ..+@@#:.                     .:%@*+#***@#..          =#
                    .=:              :%%:.                                                   ..                     .-@%*++++#*++++*@%:.       +#
                   :#+-            .%%:.                                                                         .+@%*++++*@#:@@*+++++*%@-.    +#
                 ..#=+-             -%*%@=..                                                                 ..*@#++++**@#.     .#@#*++++*%@=..+#
                +*++++-             :%+++*#@*..                                                            :#@*++++**@#.           .+@%*+++++#@%%
              :#*=*++*-             .@*++++++#@#:.                                                         .-%%**#@#..                .-%%**#%+. 
         ...:+#+++++#%%+..            :*@#*+++++*%%-.                                                         .:##:.                     .-@%-.  
.:.  .-===+#*+*++#%=.  .=%*:.            .+%%*+++++*%@=.                                                         .:##-....-:.+-           =%+*%%-
++*+*#*==+++++%%=.        .-%*:.            .-#@#*++++*#@+:.                                                        .:*@****=*+           =%++++*
+*+*=++=+++#%-.              .-##-.            .:+@#*+++++#@#-.                                                        .:*%*=++           .-%%*++
#+++=+++#%-.                    .:*%-.             .=%%*+++++*%%-.                                                        ..+@+              .-#%
#=+==%%-.                          .:*%=.             .:*@#+++++*%%+.                                                    .=%%##                 .
#=%%-.                                ..+%+.              .=%%*++++*#@*.                                              .*@#*++*%                  
%-.                                      ..=@+.              .:#@*++++*#@#:                                        :#@#*++++#@*                  
+=                                          ..-@*.              ..+@%*++++*%@-.                                 :%%*++++*%@-..                   
-%.                                            ..-@#.              ..-@@*++++*%@+.                          .=:..=@*+#@#..                       
.@:                                                 :@%:                .#@#+++++#@*.                   .--.      .@=.                           
.#=                                                    .%%:.               .=@%*++++*@#..           ..#%.          .@:.                          
 :*                                                       .#%-.               .:%@**+++*@%-.     ..*@#+*@..         .%=.                         
 .%.                                                         .*%=..               .*@#*+++*%@=..*@#+++++*@-.          **.                        
  #=                                                            .+%+..               .=%%*+++*##++++**@#++%*.          =%.                       
  =#.                                                              .+%+..                :#@#**#+*%%+.=%+++#%.          :%.                      
  :%.                                                                 .=%*:.                .+@@*:.   -%++++*%:          :%:                     
  .#.                                                                    .-##:.                       -%+++++*%-.         .%=                    
   =+                                                                       .-##-.                    -%++++++*%+.         .**.                  
   :@.                                                                      .*@#@.                    -%++++++++##          .-%.                 
.=%*:.                                                                  .:#%#*+*@.                    -%+++++++++*@:         .:%.                
=..                                                                  .-%%*++++*#@:                    :%++++++++++*@-.         .%:               
                                                                  .=@%*++++*%@=..                     :%+++++++++++*%=          .%=              
                                                               .+@#*++++*%@-..                        :%+++++++++++++%*.         .*#.            
              .-@@@@@@@@@%#**+=-:....                       .#@#*++++*@%:..                           :%++++++++++++++#%.         .-%.           
