                                                                              -@*.                                       .+@*=****+*@%:.         
                                                                         ..-@*.                                             .+@##@*.             
                                                      ...             ..-@*.                                                   ..                
                                                     .#*.            .@%.                                                                        
                                                    .#**.             =%%@=.                                                                    .
                                                  -##+**.             -%+++#@*:.                                                             .-%%
                                                .=#+++**:             :@*+++++#%#-.                                                          :#%*
                                              .:#++*+++%*:            .:*@#*+++++*%%=.                                                          :
                                        ....:+#+++++%#:..-#*:            ..=%%*+++++*%%+.                                                        
                                .**#:.=**+=++=*+*%#:.      .-##-.            .-#@#+++++*#@*..                                                    
                                .#**=++=++=*=*%#:.            .:#%-.            ..+@%*++++**%#:.                                                 
                                 =#+=*+=+=+@#:.                  .:*%=.             .-%%*+++++*%%-.                                              
                                 :#=++=*@#:.                        ..+%=.             .:*@#+++++*#@+.                                           
                                 .*=+@#..                              ..+@+.             ..=@%*++++*#@*.                                        
                                  %#..                                    ..-@*.             ..:%@*+++++*@%:                                     
  ...                             #-                                          .-@#.               .*@#+++++*@@-                                  
=%@##%:                           =#.                                            .:%#:.              .-%%*++++*%@+..                          ..-
##%####.                          :%.                                               .:#%:.               .#@#*++++#@*:.                   ..:-.  
##%###%:                          .#:                                                   .#%-.               .+%%*++++*@#:.             .-+.      
##%%###+                           =+                                                      .*%=.                -#@#*+++*%%-.       .-%%*##.     
##%%###+                           :@.                                                        .+%=.                .*@#*+++*%@=. .-#%*++++#%.    
##%%###*                           .@:                                                           .+%+:                .=%%*+++*#@%*++++*#*+*@:   
##%%###*                           .*=                                                              .=%*:                .:*@#*+**++*%%=+#+++@=  
###%###*                            :#                                                                 .-%#:                 .+%%%%+:.  =#++++%*.
###@####                            .%.                                                                   .-##-                 ..      =%+++++#%
###@##%%:                            *=                                                                      .:*%-                      =%++++++*
###@@*:.:#%-                         =%.                                                                      .:#@@.                    =%+++++++
%@=..     ..*@=. .--#:=%++%..--.   .*@=.                                                                   .-%%*+*@.                    =%+++++++
..           ..+@%+***=*==+#+*##+@@-..                                                                  .=@%*++++*@:                    =%+++++++
@+.              .-@%=*+**+*+*@%:.                                                                   .+@#+++++*@@-                      =%+++++++
++#@*..             .:%%=+*@*.                                                                   ..#@#+++++*@%:                         =%+++++++
*++++#@#..             ..=.                     ..=#**+=-:::...........                       .:%@*++++*#@#.                            -%+++++++
.#@#*+++*@#:.                                .:*@*=#+++++++++****###%%%@@@@@@@@@%#**+==-::::-%%*++++*#@*.                               -@**+++++
   .*@#*+++*@%-.                      ..  .-%%+====%*+++++++++++++++++++++++++++++++++++++++#++++*%%+.                                   ..*@#*++
      .*@#*+++*%%-.             .....:=.=%#======*@*==+**##%%%%%%%%%####*******+++++++++++++%+*%%-.                                          .+@#
         .+%#*+++*%%=.          .+-:.=%+=====+#%=.                     ....::-=++**##%%%%%%%@#-.                                                .
            .=%%*+++*%%+.        ==#+=+===+%#-.                                                                                                  
               .=%%*+++*#@+.  .=#*==+++===#+                                                                                                  ...
                  .-#%*+++*#@#+==#+===*===%+                                                                                                 =#+=
                     .:#@*++##===*=+===+==%+                                                                                                 =*=+
                        .:*@%%===*==+=====%+                                                                                                 -*=+
                           .=%===+===++===%+                                                                                                 -*=%
                            -%===+*===*+==%=                                                                                                 +@=.
                            :%====+*======%=                                                                                                 +%*%
