                                                                             -%######@#####%**.                                                  
                                                                             -%######@#####@*##-                                                 
                                                                             =%######@#####@*+=*%.                                               
                                                                             =%######@#####@*+*=#..                                              
                                                                             =%######@###%*:#%**==*..                                            
                                                                             +%######@#-.    ..*@*+*:                                            
                                                .:+*-.                       +%###%*:           ..+@+.                                           
                                                =+===%.                      +%#=.                 ..=%*:                                        
                                               *+++***=                      -@%=.                     .=%*:                                     
                                              =#*+++*+*.                     -#.:*%-.                     .-##-                       ....       
                                            .*+*++*++++*-                    -#    :*%-.                     .:#%-.                .+%%###%-     
                                           .%*=+@#::#@++%:                   .=@*.   .:#%:                      .:*%=.            =%##%#####%.   
                                          :#+@*:.    .:#@+.                    ..=@*.   .:##:                      ..+%+.       .#####%######-   
                                        .-@#..          ..*@-.                     .-@*.   .:%#.                      ..=@*.    =#####%######+   
                                     .-@*..                ..+@=.                     .-@*. :%%:                         ..-@#.:@############+   
                                  .-@*.                        .+@==%+@@=.%+#%%%.        =@#.                                .:%#######%#####+  .
                               .-@*.                              .=@##+**==**+*#**##@@@+.                                     ########%#####+.%+
                            .=@*.                                    .-%#*+++**+*++%%:.                     ...                ########%#####@***
                         .=@*.                                          .-%%++=#%*.                      .=%%%%@-.             ########%######*@*
                     ..=@*.                                                .:#+.                     ..+@%*+*%++*%@=..         ########%###%#+.  
   .*#             .=%+.                                                                          .:*@#*+++*#%*++++*#@+:.      ########%%#:.     
  .#+*             .%@*:                                                                       .:#@#++++*#%+..+%%*+++++#@*:.   ######%+.         
.=#*+#.             #*+#%#-.                                                                .-%%*++++*#%+.      .-%%*+++++*%#-.##%#=.            
%*+=*#.             +#++++*%%=.                                                           .%@*++++*%@+.            .:*@#+++++#@%-.               
=++++#.             -@%*+++++*#%+.                                                          .+@#%@=.                   .+@%%#-.                  
++*%#-*%-.           ..-%%*+++++*#@*.                                                          .=%+.                      #%%*.                  
%#:.   .:*%=.            .:*@#+++++**%#:.                                                         .=%*.*=:#*=%:           %*+*#@*.               
.          .+@+.            ..-@%*+++++*%@=.                                                         .-@%==*=#:          .%#++++**@#:            
              .=@*.             ..#@*+++++*#@+.                                                         .:%%=#:           ..+@#+++++*@%:         
                 .-@#.              .+@%*+++++#@#.                                                         .*@:               .=@#+++++*@@:      
                    .:%#..              -@@*+++++*@%:.                                                 ..#@#+%-                  .=@%*++++*%@-.  
                       .:%%:.              .#@#*++++*%@-..                                         ..:%@*++++%=                     .=@%*++++*%@-
                          ..#%:.              .=%%*++++*%@+..                                   ..=@%*++++*%%+.                        .-%%*++++*
                              .*%-.              .:#@**+++*#@*:.                             ...+@*+++*#@#:                               .-%%*++
                                 .*%=.               .*%#*++++#@#-.                       .:-.. .+%*%%=.                                     .-%%
                                    .+%+.               .=%%*++++*%%-.                ..-:.       -%.                                           .
                                       .=%+:                :*@#*+++*%@+.          .-%%%.          :@:                                           
                                          .=%*:                .+%%*+++*#@*:    .-%%*++*@:          .#-.                                         
                                             .-##-                .-#@#++++*%#+%%*++++++*@=.         .*+.                                        
                                                .:#%-                .:+@%*+++#++++*%@@*++%+.         .=#.                                       
                                                   .:*%=                 .-%@*#*%@*:. %*+++##.          -@.                                      
                                                      ..+%=.                .:+:.     #*++++*%.          .%-                                     
                                                         ..=@+.                       #*+++++*@-          .#=                                    
                                                            ..=@=                     #*+++++++%+.         .*+                                   
