                                                                              -@*.                                         .+@*+=*++@#.          
                                                                         ..-@*.                                               .=@@+.             
                                                       .*:            ..-@*.                                                                     
                                                      -#*-            .%@-.                                                                      
                                                    .:#=*-             +%*%@+..                                                                 .
                                                  .*++++*-             -%++++#@*:.                                                            -@%
                                                 -%+=*+**-             .@#*+++++*%%-.                                                         .:#
                                           .. .-**++++*%#%*:.           ..+%%*+++++*%%=.                                                         
                                   .:   .=****#+=*+*%#:.  .-##:.            .=#%*+++++*#@+..                                                     
                                  *=*#*#**=++=+++%*:.        .-##-.            .:*@#*++++*#@*:.                                                  
                                  +=*+*=++=*=+%#:.              .:*%-.             .=@%*+++++*%#-.                                               
                                  =*=*+++=+%*:.                    .:*%=.             .-#@#+++++*%%=.                                            
                                  -#++=+@*:.                          ..+@+.             ..+@%*++++*#@*.                                         
                                  .%+@*..                                ..=@+.             ..-%@*++++*#@#.                                      
                                  .%:.                                      ..-@*.              ..#@#+++++*@%:                                   
  .+%#.                            *-                                            -@#.               .=@%*++++*%@-                                
:@#%###=                           -#.                                              :%%:.               :%@**++++#@+..                        ..=
%##%###@:                          .@.                                                 :#%-.               .*@#*++++#@*:.                 ..-:.  
###%####=                          .%-                                                    .#%-.               .=%%*++++*@%-.           .-%%.     
###%####+                           =*                                                       .*%=.               .:#@#*+++*%%=.     .-%%*+*%:    
###%####+                           .%.                                                         .+%+..               .+%%*+++*%@+.-%%*+++++*@=   
####%###+                            #:                                                            .=%*:.               .-#%#+++*%#++++*#@#++%*  
####%###+                            +*.                                                              .=%*:.                :*@#*##*#%#-.+#+++#%.
####%###*                            :%.                                                                 .-##:.                .=%%=.    +#++++*%
####%###*                            .%.                                                                    .:#%-.                       +#+++++*
####%#%@%#:.                          +=                                                                       .:*%-                     +#++++++
###%@+.. .:#%-.                       :%.                                                                     .:#%*%                     =#++++++
%@=..       ..+@=.:%#*%*+##+=##*.==.*@=.                                                                   .=@%*+++@.                    =%++++++
+.             ..=@%+**++*#*+*+**@%:..                                                                  .+@%*++++*%@.                    =%++++++
+#@*.               -@%=*+*#=+@#.                                                                    .*@#+++++*@%:                       =%++++++
++++#@*..              :@%#@*.                                                                   .:#@*+++++*@#.                          -%++++++
#@**+++*@#:.                                    ..+@@@@@@@@@@%##*+==-:::..........           ..-%@*++++*#@*.                             -%++++++
  .*@#*+++*@%:.                              .:#@+==#++++++++++++++++++++****###%%%@@@@@@@@%%@%*++++*#@+.                                .#@**+++
     .*@#*+++*%%-.                     -...-%%+=====###********+++++++++++++++++++++++++++++*%+++*%%=.                                      .*@#*
        .+@#*+++*%@-.             :..--==%*======*@+.    ..::-==+*###%%%%@%%%%####*******++++%*%%-.                                            .+
           .+%%*+++*%@=.         .=..=#*=====+%%=.                                ...:--=++***:.                                                 
              .=%%*+++*#@+.      .+#+==*+==*#:.                                                                                                  
                 .-%%*+++*#@*:.=#++=++=+===#=                                                                                                 .=+
                    .-#%*++++%*===*===+*===#=                                                                                                 -**
                       .:#@*+##===++===*+==#=                                                                                                 -++
                          .:*@%===+++==+===#=                                                                                                 -++
                             -%===+==*=+===#=                                                                                                 -*%
                             -@===+===*++==#=                                                                                                 =@@
                             :@===+*===++==#=                                                                                                 =%+
