                                                                                       .%#######%####@@%+***%=                                   
                                                                                       .%#######%%#..   :@%+**#.                                 
                                                            ....                       .@#####%+.          :%@*.                                 
                                                          .@+==#=                      .@#%%-                 .#%-..                             
                                                         .*#*+*#=.                     .%%:.                     .*%=..                          
                                                         -#*+++**-                      #=:##:.                     .=%*:.                       
                                                       .=#==***==#*.                    #-  .-##:.                     .=%*:.                 .-#
                                                      .%+++#%*%%++**.                   =%=.   .-%*:.                     .-##-.             -%##
                                                     :#=%%=.   .-%%%.                     .+%=.   .-%*..                     .:*%=.        .*####
                                                    .%%=.         .-##:.                     .+%+.   .=%+.                      .:*%+.     +#####
                                                 .*%=.               .:#%-.                     .+%+.  .+@=                        ..+@+. -%#####
                                              .*%=.                     .:*%=.-.==:..%#+.+:        .+@@=.                             ..=@@######
                                           .*@-..                          ..*@**+***+*=*=%#*#*:*-#%-.                                   .%######
                                        .*@-..                                ..+@#=**+****=*+*@#..                                      .%######
                                     .*@-..                                      ..=@#+=#*=%@=..                     .*@@#..             .%######
                                  .#@-                                                -@@@-.                      .#@*+*#+*@%:.          .%######
              .-:             ..*@-                                                                           .:%@*++++#*++++*%@=..      .%######
             .#==            .+@=..                                                                        .-%%*++++*%%-#@#*++++*%@+..   .%######
           ..+*++             .%*#@*:.                                                                  .=@%*++++*%%-.    .+@%*+++++#@*:.:%##%#:.
          :#+*=*+              %*+++#@#:.                                                            .*@#+++++*%#-           .=%%*+++++#@%@*.    
        .*#=++++*              ##*+++++*%%-.                                                         .:*@#**%#-                 .:#@#*#@*:.      
   .. .=#+++++*@%*:.            .+%%*+++++*%@+.                                                         ..*%=.                     ..@@=.        
:++++**++++*%+.  .-##-.            .-#%*+++++*#@*:                                                         ..+%=..:.::.-+.          .@+*%@+.     
*+=++++=#%=.        .:*%-.            .:*@#*+++++#@#-                                                         ..+@#**#=+@.          :@++++*#@+.  
+++*=#%=.              .:*%=.            ..=%%*+++++*%%=.                                                         .=%#+=%.          .:*@#++++*#@*
+=#%=.                    ..+%+.             .:#@#+++++*%%+.                                                         .=@%.             .:*@#++++*
%=.                          ..+@+.             ..+@%*++++*#@*.                                                    .-%%#@.                .:+@#++
                                ..-@#.              .:%@*+++++*@%:                                              .+@%*++*@.                   ..+@
                                   ..-@#.              ..*@#+++++*%@-.                                       .*@#*++++*@%.                      .
                                        :%%:                =@%*+++++%@=.                                 .#@*+++++%@+.                          
                                           :%%:..              :%@**++++#@*..                        ..--. :@***@%:.                             
                                              .#@-..              .+@#*++++*@#:.                  .:=.      .%*.                                 
                                                 .*@=..              .-%%**+++*@%-..           .+@:          .#=.                                
                                                    .+%+..               .#@#*+++*%@=..     .+@#++%=.         .**.                               
                                                       .+%+..               .+%%*+++*#@+:.+@#++++++%*.          =%.                              
                                                          .=%*:.               .-#@#*+++#%*++++*%%++##.          :@:                             
                                                             .-##:.                :+@#*+#+*%@*::@+++*@:          .%-.                           
                                                                .-##-.                .=%@#-.   :@++++*@-          .#=.                          
                                                                   .:*%=.                       :@++++++%*.         .+*.                         
                                                                      .:+%+.                    :@+++++++##.          =%.                        
                                                                      .+%#@-                    :@*+++++++*%.          :@:                       
                                                                   .#@#*++%=                    :@*++++++++*@-          .%-.                     
                                                                :%@*+++++*@=                    :@*++++++++++%+          .#+                     
                                                             :@@*+++++#@*..                     :@*+++++++++++##.         .+*                    
