                                                                             .%######@#####@+#.                                                  
                                                                             .%######@#####@+#++.                                                
                                                                             .%######@#####%**++*.                                               
                                                                             .%######@#####%#+++*-.                                              
                                                                             .%######%###%*.+%#*+=#:.                                            
                                                                             :%######@#-.     .=%%+*=                                            
                                                .-+#+.                       :%###%*:            .-##-.                                          
                                                :#=+=@.                      :@#=.                   :*%-.                                       
                                               -++****#.                     .@##:                      :+%=.                                    
                                              -%+*++*+%:                     .% .-%*:                      .+%+.                      .::..      
                                            .*++++**++++*.                   .%    .-@*.                      .=%*.                .=%#%##%*.    
                                           .*+++@#:.=@#=*=                   .:#%-    .=@+.                      .-%#:            -%###%####%:   
                                          .#+@*:.     .=@%.                     .:*%-    .=@+.                      .:#%:.      .+%####%#####*   
                                        .-%#..           .-@#.                     ..*@-.   .+@=                       ..#%-.   -%#####%######   
                                     .-@*..                 .:@#.                     ..*@=.:%%:.                         ..*@=.%######%######   
                                   -@*.                         :%%-@*@%#:%++%@%:...     =@#.                                 .*#######%######  .
                               .-@*.                               .#@****+=+***+**+%%@@=.                                     +#######%######.#*
                            .=@*.                                     .*@*+*+**=**+%%:.                     .:.                +#######%#####@#*+
                         .=@*.                                           .+@#=+#%*.                     ..=%%%#@*:.            +#######%#####%*@*
                     ..=@+.                                                 .++.                     ..+@%*++%*++*@#-.         *#######@###%#=.  
   .*%.            .=@+.                                                                          .:*@#*+++*#@*+++++*%%-.      *#######@%#:.     
   ++#.             +@%=.                                                                      .-#%#++++*#%+..:*%#+++++*%%=.   *#####%+.         
.+##+#:             =%+*#%+.                                                                .=%%*++++*#%+.       .+%#*++++*#%+.*#%#=.            
*++=*#:             -@++++*#@*:.                                                          .+@#++++*%@+.             .=%%*++++*@%-.               
=*+++#-.            .#@#+++++**%#-.                                                         .-#%%@=..                  .-#@@#-.                  
+++%#:=%*..           .:+@%*+++++*%%=.                                                         .:#%-.                     =%%%-.                 
@#:.    .-%#:.            .-%%*+++++*#@+.                                                         .:*%-+#-##*%+           +#++*%%=.              
.          .:%%:.            ..*@#+++++*#@#:                                                         ..*@*=+*++           +@*++++*%@+.           
              ..#%-.            ..=@%*+++++*@%-                                                         ..+@*+=            .:%@*++++*#@+.        
                  .#@-.              :%@*+++++*%@=                                                         .*@+                .%@*+++++#@*.     
                     .*@=..             .*@%*+++++#@+..                                                .:#@#+#*                   .#@*+++++#@*.. 
                        .+@+..             .-%%*+++++#@#..                                         ..-%@*++++#*                      .#@#*++++*@#
                           .=%*..              .#@#*++++*@%:.                                   ..=@%*++++*%%=.                         .*@#*++++
                               =%*:.              .+%%*++++*%%-.                             ..::@*+++*#@#:                                .*@#*+
                                  -%#:.               -#@#*+++*%@+.                       .:-.   :%#%%=.                                      .+@
                                     -##-.               .*@#*++++#@*:.               ..-:        .%-                                            
                                        :*%=.               .=%%*++++*%#-.         .-%%@:          .#+                                           
                                           :*%=.               .:*%#*+++*%%=.   .-%%*++*@=           +#.                                         
                                              .=%+.                .=%%*+++*#@*%%*+++++++%#.          -%.                                        
                                                 .=%*.                .-#@#+++#*+++*%@%#++*@.          :%:                                       
                                                    .-%#.                .:+@%#*%@*:. *#+++*@:          .%-                                      
                                                       .:%#:.               ..-:.     *#++++*%=          .#*                                     
                                                          .:#%:.                      *#++++++%*          .=%.                                   
                                                             .:@#.                    *#+++++++#%.         .:%.                                  
