                                                                              .%@:                       .#@:.:.==..:%%=.*.        .+@@-.        
                                                                          .:#%:                             .*@+*+*++*+=*=%%*%=:*=%%:            
                                                                       .:#%:                                   .*@*+***+***=**#@*.               
                                                                    .:#%-                                         .+@*+=#*+%%=.                  
                                                                 .:#%:                                               .=%@#:.                     
                                              .=:             .-##:                                                                           .=%
                                             .#=-            .*@=.                                                                         .+@%*+
                                           .:#++=             :%*#@*..                                                                  :*@#+++++
                                          =*++=*=             .%+++*#%#:.                                                            :#%#+++++#@*
                                        :#*=*+++=              %#*+++++*%%=.                                                         .:*@#+#@*:  
                                   .. .**+++++#@%#:.           ..=@%*+++++*%@+.                                                         .:*@=.   
                          .:.   :****#*=*++#%-.  .:##:.            .-%@*+++++*#@*.                                                         ..+%=.
                         ++=%##**==*=++=%%-.        .:#%-.            .:*@#*++++**@#:                                                         ..+
                         =*+=*=+*=*+=%@:.              ..*%-.            ..=@%*+++++*@%-.                                                        
                         :%+++=*==%@:.                    ..*@=.            ..:%@#+++++*%@=.                                                     
                         .#=*==%@:                            .+@+.              .+@%++++++#@*.                                                  
                          *=%%:                                   =@*..             .-%@**++++*@#:.                                            ..
                          *-.                                        -%*:.              .*@#*++++*%%-.                                      .:#@#
                          -*.                                           -%#:.              .=%%*++++*%@=.                                ..%@*+++
                          :@.                                              :##-.               -#@#*++++#@+:                         ..-:  -@**#@
                          .@-                                                 :*%-.               .*@#*++++#@#:.                  .:-.      .@*. 
                           ++                                                    .*%=.               .=%%*++++*%#-.            :*@:          .#-.
                           .%.                                                      .+%+.               .:*@#*+++*%%=.      :*@#+*@-.         .#+
                            %:                                                         .=%*.                .=%%*+++*#%*.:*@#+++++*%+.          +
                            *+.                                                           .=%*:                .-#@#+++*#%+++++#@%++##.          
                            -#.                                                              .-%#:.                :+@%*+#+*%%=.-%+++*@.         
                            .%.                                                                 .:##:.                .-%@+:.   :%++++*@-        
.                            *-                                                                    ..*@-.                       :%++++++%+.      
%:.                          -#.                                                                      ..*@=.                    :%+++++++##.     
 .#@-.                       :@.                                                                      .*@#@:                    :%++++++++#%.    
    .+@=..%+%%+##@*+=@@..=.-@#.                                                                   .:%@*+++@-                    :@+++++++++*@:   
       .=@#***+=**#=+*+*#@+.                                                                   .:%@*++++*#@-                    :@+++++++++++@=  
           -%%+*+*+++%%=                                                                    .=@%*++++*#@+.                      :@++++++++++++%*.
              :%%#%#:                                                                    .+@%*++++*%%=.                         :@+++++++++++++##
#:.              .                      .=%@@@@@@%%##*++==---:::......                :*@#+++++*%#-                             :@++++++++++++++*
+*%%-.                               .+@#==#+++++++++++++++++*****####%%%%%@@@@%%##*#@#+++++#@#:                                .*@#*++++++++++++
*+++*%%=.                     ..  :*%*=====*###*****++++++++++++++++++++++++++++++++#+++*#@*:                                      .+%#*+++++++++
+@%*+++*%%=.             :..:-:=##======*%*-....::--==++**##%%%@@%%%%####*****++++++%*%%+.                                            .=%%*++++++
  .=%%*+++*#@+.         .=:.-#*======#%=.                             ....:::--==++**-.                                                  .-%%*+++
     .-%%*+++*#@*.       +#+===*==+%-.                                                                                                      .:#@*
        .-%%*+++*#@#:.-#++==+=====*#.                                                                                                .:+:      .:
           .:#@*++++#@===*===+++==*#.                                                                                                :#*%*%:+##@#
              .:#@*+*@===+*====*==*#.                                                                                                :#=*++***@+.
                 ..*@@====+*===+==*#.                                                                                                :#+*=#@=..  
