                                                                          .#=*=#@#@#+**#.                   -@-     :@#.                       .%
                                                                         .%=+@*.    -@%#.                     .*@=..   -@*..                     
                                                                        .*@*.          :%#:.                     .*@=..  .=@+..                  
                                                                     .=@*.                :%%:.                     .+@=.. .-@*                  
                                                                  .=@*.                      :#%-.:.:-:..##-:-:        .*@%*.                    
                                                               .+%+.                            .*%*#*+**++=*=#+#%#:=-*%=.                       
                                                            .+%+.                                  .+%*+**+***++***%#-.                          
                                                         .+%+.                                        .=%#*+*++#@*:.                     .+%@#-  
                                                      .+@=..                                             .=%%%=.                      .*@#**%+*%%
                                  .--              .+@=.                                                                          .:#@#*+++*#++++
                                  *+*             -@+.                                                                         .-#%**+++*%%=*@#++
                                .-*+#             .%*#@*.                                                                   .=%%*++++*%%=.    .=@
                              .*+*=*#.            .%*++**@#:                                                             .+@#*++++*%@-.          
                            .+#==*+*%.            .##++++++*%%-.                                                         .:#@#+*%@-..            
                       .  .-%+*=**+@@#.            ..+@%++++++*%@=.                                                         ..*@-.               
                    .---=##*+**+@*.   :%%.             .:%@*++++++#@*.                                                          .*@=. . .. -+.   
             -#=#++%*+=++=*=*@*.         .#%-.             .*@#*+++++*@#:.                                                         .+@%**+=+@.   
             .#==++=++=*=*@*.               .*%-.             .=%%*+++++*%%-..                                                        .+@#+=@.   
              #*=+=++=*@*.                     .*%=.              :#@#*++++*%@=..                                                        .=@@.   
              *=++=#%*.                           .+%+.              .+@%*++++*#@*:.                                                   .:#@#@:   
              +=*%+.                                 .=%*:.             .-#%**++++#@#:.                                             .-%%*++*@:   
              =#.                                       .-%*:.             .:*@#*++++*%%=.                                      ..+@%*++++*%%:   
              :@.                                          .-##-.              .=%%*++++*%%+.                                ..+@#*+++*#@*:.     
              .@:                                             .:##-.              .-#@#++++*#@*:                          .-:..:@*+*%%=.         
               +=                                                .:*%=.               :+@%*++++#%#:                   .:-:.     .%#:.            
               :#.                                                   :+%+.               .-%%*++++*%%=.            .=%-          .*+.            
               .%:                                                      .=%+.               .:*@#*+++*%%+.      .=@%*+%+.         .=#.           
               .#=                                                         .-@*.               ..=@%*+++*#@#..=@%*+++++##.         .-%.          
                -*                                                            .:%#.                .:#@*++++*%*++++*%@*+*%.          :@:         
                .%                                                                .%%.                 .+@%+*%++#@#::@*++*@:          .%=        
                 #-                                                                  .#%:.                .-@@%-.   :@*+++*@=           **.      
                 =#.                                                                    .#%-.                       :@*+++++%*.          =#.     
                 :@.                                                                       .*%=.                    :@*++++++#%.         .-%.    
                 .%:                                                                      .-%%@-                    :@*+++++++*%.          :@:   
%#-%###%-+#::-.:*%=.                                                                   .=%%*++%=                    .@*++++++++*@-          .%=  
*#+++*+++**#*%#-.                                                                  .:+@#*++++*@=                    .@*+++++++++*%+          .*+.
%%+++*+++*@*:.                                                                  .:*@#+++++#@#:.                     .@*+++++++++++##.         .=#
 .-#%*#%+..                                                                  .-#%*++++*#@*:.                        .@*++++++++++++*%:          -
     ..                     .:#@@%%%%###***+==--::....                    .=%%*++++*%@+..                           .@*+++++++++++++*%-          
                         .-%%+=*#++++++++++++********#####%%%%%%%%%%###**@#*++++*%@-.                               .+@#+++++++++++++*%=         
                  ..  .+@#=====+%***++++++++++++++++++++++++++++++++++++#*+++*@%-.                                     .=@%*+++++++++++%#        
             :...-::*%+======%@-....:::--=+*#%%@@@@@@@%%###***++++++++++#*#@#:.                                           .-%%*+++++++++#@.      
@*.         .=-..*#+=====+@%:..                       .........::-==+*#%@*..                                                 .:%@*+++++++*@:  .:-
++#@*.       .##=======@*..                                                                                                     .:%@*+++++*@-:.  
