                                                                 @=@==*==@#                          @@                :@@+++++++@@              
                                                                 -====@*                                @@                 @@+++++++@@           
                                                                  +@=                                      @@                 *@#++++++@@:       
                                                                  @                                           @@.                .@@++++++*@%    
                                 @@#@.                            @                                              *@:                 @@*++++++@@ 
                               @##@###                            %:                                                -@+                 :@@++++++
                              =###@###@                            @                                                   .@%                  @@+++
                              @###@###%                            @                                                       @@                  #@
                             =####@####                            @.                                                         @@                 
                             @####@####                            .@                                                            @@              
                             @####@####                             @                                                               @@.          
                             @####%####                             @                                                                  @@.       
                             @#########.                            .@                                                                    =@=    
                             @#########.                             @                                                                       .@% 
                             @######%@==@+                           @                                                                          .
                             @###@@.      .@@                        @+                                                                      .@@+
                             *@@              @@ @##=%@===*@*=:@@+@@                                                                      =@#++++
                             @@@                 @@=+=#+==*@===@@                                                                      @@*++++++@
                             @+++@@                 @@=*%+=+@*                                                                      @@+++++++@@  
                             @%+++++@@.                =@@.                                                                      @@++++++*@%     
                               .@@+++++%@:                                      @@=++++*#%@@@@@@@@@@@@@@@+:..                .@@++++++%@:        
                                   @@+++++*@+                                @@====%++++++++++++++++++++++++++++++++++*#%@@@*++++++@@.           
                                      @@+++++*@%                      -  =@#======*@@@@@@@%#++++++++++++++++++++++++++++++++++++@@               
                                         @@++++++@@                %  @@=======@@                    .-*%@@@@@@@@@@@%**+++++*@@                  
                                            @@++++++@@          .  *%=*=====@@                                                                   
                                               @@++++++@@       #%====@===@                                                                      
                                                  #@*+++++@@.@#===+===%===@                                                                      
                                                     =@#++++@====+==@=@===@                                                                      
                                                        :@%+@====%===#@===@                                                                      
                                                           .@====@====@*==@                                                                      
                                                            @====%=#==%===@                                                                      
                                                            #*===*==%=#===@                                                                      
                                                            :%========*===@                                                                      
                                                            .@========+===@                                                                      
                                                             @=====+==+=+  -@+                                                                   
                                                             @=======#        .@@                                                                
                                                             @====@              .@@                                                             
                                                             @=#                @@+@                                                             
                                                             @@                 @@+@                                               @@+           
                                                             @++@@.                @@.                                            @%%=@          
                                                             @+++++#@=                +@-                                       @@@=@=+=@        
                                                             -@#++++++*@@                .@@                                  @@=@@. .@@==@  .#  
                                                                .@@+++++++@@                 @@                            .@=@@.        @@*+%=@ 
                                                                    @@+++++++@@                 @@                        @@@.              @@==+
