                @####@###%                              @                                                                        @@              
                @####%#@%  @@                           @                                                                          @@            
                @##%@=        @@      =  %   =         =@                                                                       @@++@.           
                @@.              @@.%=#==@=@=#%==@%=@@.                                                                     .@@+++++#=           
                @%@:                =@*@%=#%*=#==@@                                                                      *@#++++++@@             
                @+++#@=                .@@=#==@@                                                                      @@+++++++@@                
                @@+++++*@%                 @-                        ..                                            @@+++++++@@                   
                   @@++++++@@                                     @@=+++++++++++*#%@@@@@@@@@@@@@@%=..          .@@++++++*@*                      
                      @@++++++@@                               @@=====++++++++++++++++++++++++++++++++++++++++#++++++@@:                         
                         %@*+++++@@                     .. .@%======+@@@@@@@@@@@@@%**+++++++++++++++++++++++++*+++@@.                            
                            +@*+++++@@.              @  =@=======@@.                        ..-*@@@@@@@@@@@@%**@@                                
                               -@#+++++@@.           :@=======@@                                                                                 
                                  .@@+++++#@=     :@====@====@                                                                                   
                                      @@+++++*@@@===+========@                                                                                   
                                         @@++++@======#======@                                                                                   
                                            @@+@===#===#=+===@                                                                                   
                                               @===*=====#===@                                                                                   
                                               @====+#===*===@                                                                                   
                                               @====#=@==*===@                                                                                   
                                               @====@===*#===@                                                                                   
                                               @====%====%===@                                                                                   
                                               +*===*====@=.   @@                                                                                
                                               .@======+          @@                                                                             
                                               .@===#                @@                                                                          
                                                @@                @@++@                                                                          
                                                @@+                #@*@                                              %@*@                        
                                                @++*@@                .@@                                           @@=+%@                :@#=%=%
                                                @++++++@@                 @@                                       %@=*@=#=@             @+==@**=
                                                .@@+++++++@@                 @@                                 @@=*@:   @@==@  @@     @+@=+%=@@=
                                                    @@+++++++@@.                %@.                           @=*@:         *@+=@#@= -@=*==@@- @@
                                                       @@*++++++#@=                -@*                       %@:               .@@==@==#@@       
                                                          -@%++++++*@@                .@@                 =@:                      @@@#          
                                                             .@@+++++++@@                 @@           =@-                                       
                                                                 @@+++++++@@                 @@.     :@+                                         
                                                                    @@*++++++@@.                +@+  @+++@.                                      
                                                                       -@%++++++#@=                .@@@=                                         
                                                                          .@@++++++*@@                                                           
                                                                              @@+++++++@@                                                        
                                                                                 @@*++++++@@                                                     
                                                                                    =@%+++@*                                                     
                                                                                       +@                                                        
                                                                                       :%+%@-                                                    
                                                                                       .@+++++@@                                                 
                                                                                        @++++++++@@                                              
