                       +########.                           @                                                      @@                  +@%++++++@
                       @########@                           .@                                                        @@                   @@++++
                      .#########@                            @                                                           @@.                  @@*
                      *#########@                            @                                                              *@:                  
                      -#########@                            -*                                                                -@+               
                      :#####%###@                             @                                                                   .@@            
                      .#####@###@                             @                                                                       @@         
                       #####@##@@@                            *-                                                                         @@      
                       #####@@     @@                          @                                                                        @@+@     
                       ##@@           @@   @ %@.=@@=.*@@  . :@@                                                                      @@++++@     
                      @@                 @@=+=@==%=+=*=*%%@:                                                                      @@++++++*@     
                      @++@@.                +@*=%==+==@@                                                                      :@%++++++@@.       
                      @+++++#@-                .@@-@@                                                                      *@*++++++@@           
                        @@+++++*@#                                        .@@@@@@@@@@@#+:..                             @@+++++++@@              
                           @@++++++@@                                  %@+==@+++++++++++++++++++++++*#%@@@@@@@@@@@@@@@@++++++*@@                 
                              @@++++++@@                       -    @@======@++++++++++++++++++++++++++++++++++++++++@++++#@*                    
                                 @@++++++@@               *  .:: @#=======@@        ..=#@@@@@@@@@@@@%**++++++++++++++@+@@.                       
                                    #@*+++++@@            @   @=======%@-                                      :-#@@@@                           
                                       =@#+++++@@.        @@=======#@                                                                            
                                          :@%+++++%@:  .@=#==@=====%:                                                                            
                                             .@@+++++%*===+====*===%:                                                                            
                                                .@@++*@====*====@==@:                                                                            
                                                    @@@=====@======@:                                                                            
                                                      @=======+====@.                                                                            
                                                      @===+====+===@.                                                                            
                                                      @====%=======@.                                                                            
                                                      @======@=====@.                                                                            
                                                      @=======%====*@@                                                                           
                                                      @====+====-      @@                                                                        
                                                      @====+=.            @@                                                                     
                                                      @===.               :@@*                                                                   
                                                      @.                @@++*#                                                                   
                                                      =##@=                @@@                                              +==#.                
                                                      .@+++*@@                :@@                                         @=*+=*@*              @
                                                       @+++++++@@                 @@                                     @==@@@@=%@+           -=
                                                         @@+++++++@@                 @@.                              @==@@      @@=@@*=#    @%==
                                                            @@+++++++@@.                @@.                         :=@@            *@+=*=*@=%==%
                                                               @@*++++++#@=                -@*                     @@                  .@@=@=@@  
                                                                  -@%++++++*@@                .@@              .@@                         %     
                                                                      @@+++++++@@                 @@         @@                                  
                                                                         @@+++++++@@                 @@.    @#@*                                 
                                                                            @@*++++++@@.                +@= @+@@.                                
                                                                               -@#++++++#@-                .=                                    
                                                                                  .@@++++++*@%                                                   
