                 @#########:                             @                                                                    @@                 
                 @#########-                             @                                                                       @@.             
                 +#######@@@@                            @                                                                          #@:          
                 -####@@      @@.                        .@                                                                       #@*+@          
                 .#@@            =@+ @@@=@%====.@+@.@#.@@                                                                      @@+++++@          
                 @@%                .@@=@=*@=+=#=*=%@+                                                                      @@++++++*@@          
                 @+++@@                 @@=++*==@@.                                                                     .@@++++++#@=             
                 @++++++@@                 @@@@                                                                      -@%++++++@@.                
                   #@*+++++@@                                       .@@##@@@@@@@@@@@@@@@+:.                       @@*++++++@@                    
                      +@*+++++@@                                 =@#===@++++++++++++++++++++++++++++**#%@@@@@@@@@+++++++@@                       
                         :@%+++++@@.                      #   @@=======@@@%**+++++++++++++++++++++++++++++++++++#+++*@%                          
                            .@@+++++#@-              .  - @@#=======@@               .-*@@@@@@@@@@@@#**+++++++++%#@=                             
                               .@@+++++*@*          %.  @=@=====#@+                                            ..                                
                                   @@++++++@@        @====@#==@                                                                                  
                                      @@++++++@@  @==#=%==%===@                                                                                  
                                         @@+++++@====@===##===@                                                                                  
                                            @@++@====%====@===@                                                                                  
                                               @@====*%===+===@                                                                                  
                                                =#===+==+=====@                                                                                  
                                                .@=======+====@                                                                                  
                                                 @===@====*===@                                                                                  
                                                 @=====@======@                                                                                  
                                                 @======@====@ @@                                                                                
                                                 @===#====#       @@.                                                                            
                                                 @=====-             *@:                                                                         
                                                 @==.               .@@@                                                                         
                                                 @@                :@@+@                                                @.                       
                                                 @++@@                 @@                                             .=@=+                  .@#=
                                                 %*++++@@                 @@                                        :#=#+@*=@              #=#===
                                                 -@+++++++@@.                @@.                                  +@==@@ @@==+@   .      =@+#==%=
                                                    @@*++++++#@=                =@+                             @==@@       -@@#@==@    %==@==@@@
                                                       -@#++++++*@@                .@@                        .@@@              @@==%==*==*@%    
                                                          .@@+++++++@@                 @@                    @@                    @@==@@.       
                                                              @@+++++++@@                 @@.             @@                                     
                                                                 @@+++++++@@.                +@=       @@                                        
                                                                    +@#++++++#@=                .@@    @+@@                                      
                                                                       .@@++++++*@@                 @@+#@@.                                      
                                                                           @@+++++++@@                                                           
                                                                              @@+++++++@@                                                        
                                                                                 +@#++++++@@.                                                    
                                                                                    .@@+++++@@                                                   
                                                                                        @@@                                                      
                                                                                         @#@*                                                    
                                                                                         @++++@@                                                 
