                .#####@###@                             @                                                                      .@@               
                 #####@##@@#                            *=                                                                         @@            
                 #####@@    .@@                          @                                                                        +@#@           
                 ##@@           @@   @ @# *@@*.:@@  .  @@                                                                      @@*+++@           
                @@                 @@=#=@==#=%==+=%+@%                                                                      @@+++++++@           
                @*+@@.                %@+=@===+=@@.                                                                      @@++++++#@+             
                %*++++@@.                :@#=@@                                                                      :@@++++++@@.                
                  @@+++++#@=                                         @@@@@@@@@@%-..                               @@*++++++@@                    
                     @@+++++*@#                                  -@%==@+++++++++++++++++++++**#@@@@@@@@@@@@@@@+@@+++++++@@                       
                        @@++++++@@                       :    @@======%++++++++++++++++++++++++++++++++++++++++@+++++@@                          
                           @@++++++@@               +   *. @@=======@@       .:=#@@@@@@@@@@@@#*++++++++++++++++@+#@+                             
                              @@++++++@@            @   @=======+@@                                    .:=@@@@@@.                                
                                 %@*+++++@@.        #@=======+@.                                                                                 
                                    =@*+++++@@.   @=*==*=====#=                                                                                  
                                       :@%+++++%#===+====@===%-                                                                                  
                                          .@@+++@=========#==%-                                                                                  
                                              @@@=====*======%-                                                                                  
                                                @=======%====@:                                                                                  
                                                @===%====#===@:                                                                                  
                                                @====%=======@.                                                                                  
                                                @======%=====@.                                                                                  
                                                @=======@====@@@                                                                                 
                                                @====%====%     .@@                                                                              
                                                @====+==            @@                                                                           
                                                @===:               .@@#                                                                         
                                                @                 @@++*@                                                                         
                                                -%@@.                @@@                                              *==@.                   @@@
                                                 @+++*@*                =@+                                         @=+#=+@-              @==@=+@
                                                 @++++++*@@                .@@                                     @==@@@@=%@-           .==@====
                                                  .@@+++++++@@                 @@                               @==@@      @@=@@@=%    @@+=*==@@=
                                                      @@+++++++@@                 @@                           =@@            @@==%=@@=#==+@@    
                                                         @@+++++++@@.                #@-                     @@                  :@%=%=@@.       
                                                            *@*++++++*@*                .@@               @@                         @           
                                                               .@@+++++++@@                 @@         @@                                        
                                                                   @@+++++++@@                 @@.    @@@-                                       
                                                                      @@+++++++@@                 %@: @+@@:                                      
                                                                         #@#++++++@@:                :@                                          
                                                                            .@@++++++*@#                                                         
                                                                                @@+++++++@@                                                      
                                                                                   @@+++++++@.                                                   
                                                                                      #@*@@                                                      
                                                                                        @@@                                                      
                                                                                        @+++@@:                                                  
                                                                                        @++++++*@@                                               
