                               -:                             @:                                            +@-                 @@*++++++@@      
                            @#%###:                            @                                               :@#                 -@@++++++@@   
                           @######@                            @                                                  .@@                  @@++++++@@
                          .########.                           @.                                                     @@                  #@*++++
                          @########@                           .@                                                        @@                  .@@+
                          #########@                            @                                                           @@.                  
                         =#########@                            @                                                              @@.               
                         :#####%###@                            .@                                                                *@-            
                         .#####@###@                             @                                                                   :@#         
                          #####@###@                             @                                                                      .@@      
                          #####@##@@*                            ++                                                                         @@   
                          #####@@     @@                          @                                                                        =@#@  
                          %#@@           @@   @ @# *@@#..@@  .  @@                                                                      @@*+++@  
                         #@                 @@=#=%==#=%==+=@=@@                                                                      @@+++++++@  
                         %*+@@.                #@==@===+=@@:                                                                      @@++++++*@*    
                         **++++@@.                -@#=@@                                                                      .@@++++++%@:       
                          .@@+++++#@=                                         @@@@@@@@@%*-..                               #@*++++++@@.          
                              @@+++++*@%                                  :@@==@+++++++++++++++++++++*#%@@@@@@@@@@@@@@@=@@+++++++@@              
                                 @@++++++@@                       .    #@+=====%++++++++++++++++++++++++++++++++++++++++@+++++@@                 
                                    @@++++++@@               =   #. @@=======@@       .:+%@@@@@@@@@@@@#*++++++++++++++++@+*@#                    
                                       @@++++++@@            @   @=======+@@                                    .:+@@@@@@:                       
                                          @@*+++++@@         +@========@.                                                                        
                                             +@*+++++@@.   @=+==+=====#+                                                                         
                                                :@%+++++##===*====@===#=                                                                         
                                                   .@@+++@=========*==#=                                                                         
                                                       @@@=====+======#-                                                                         
                                                         @=======@====%-                                                                         
                                                         @===@====%===%:                                                                         
                                                         @====#=======%:                                                                         
                                                         @======#=====%.                                                                         
                                                         @=======@====@@@                                                                        
                                                         @====@====@     .@@                                                                     
                                                         @====*=+            @@                                                                  
                                                         @===:                @@%                                                                
                                                         @.                @@++*@                                                                
                                                         :@@@.                @@@                                              #==@.             
                                                          @+++#@*                =@=                                         @=+%=+@-            
                                                          @++++++*@@                .@@                                     @==@@@@=%@-          
                                                           .@@+++++++@@                 @@                               @+=@@      @@=@@@=%    @
                                                               @@+++++++@@                 @@.                          =@@            @@==%=@@=#
                                                                  @@+++++++@@.                #@-                     @@                  :@%=%=@
                                                                     #@*++++++*@*                .@@               @@                        .@  
                                                                        .@@+++++++@@                 @@         @@                               
                                                                            @@+++++++@@                 @@     @@@-                              
