                    @####@####                             @                                                            @@                   @@++
                    @####%####                             @                                                               @@                   #
                    @#########                             @.                                                                 @@                 
                    @#########.                            .@                                                                    @@.             
                    @#########.                             @                                                                       =@-          
                    @#######@@@@.                           @                                                                          :@:       
                    %####@#      -@*                        -#                                                                       @@+*@       
                    =%@:            .@@ @@@=@@===+*#==+@*%@:                                                                     .@@+++++@       
                    @@@                 @@=%=@*===%=#=@@                                                                      -@%++++++@@.       
                    @+++@@                 @@=#@%==@@                                                                      @@*++++++@@           
                    @*+++++@@                 @@@*                                                                      @@+++++++@@              
                      :@%+++++@@                                       %@+*+**%@@@@@@@@@@@@@@#+:.                    @@++++++*@@                 
                         .@@+++++%@:                                @@====@++++++++++++++++++++++++++++++++*#%@@@@@@++++++#@=                    
                            .@@+++++*@+                      =  .@@=======@@@@@%#*+++++++++++++++++++++++++++++++++*+++@@.                       
                                @@+++++*@@                *  +@=======%@=                 .:*@@@@@@@@@@@@@#*+++++++*@@                           
                                   @@++++++@@          -. .@=#=====@@                                                                            
                                      @@++++++@@       .@====@===@                                                                               
                                         @@++++++@@ :@==+=+==@===@                                                                               
                                            @@*++++@====#==+=@===@                                                                               
                                               *@*+@====@====%===@                                                                               
                                                  -@====%+===#*==@                                                                               
                                                   #+===#=%==*===@                                                                               
                                                   =*===+==%=*===@                                                                               
                                                   .@========#===@                                                                               
                                                   .@=====+======@                                                                               
                                                    @===========. %@.                                                                            
                                                    @========        =@=                                                                         
                                                    @====*              .@#                                                                      
                                                    @=%                @@*@                                                                      
                                                    @@                 @@+@                                               :@:                    
                                                    @++@@                 @@                                             =%#=@                  #
                                                    @+++++@@.                @@.                                       @@#=#+==@              =@@
                                                    =@*++++++#@+                -@+                                  @@=+@- -@#==@   =     .@%%==
                                                       =@#+++++++@@                .@@                             @=+@-        @@%#%=@   :===+=#
                                                           @@+++++++@@                 @@                        @%@=              @@==#==#==@@  
                                                              @@+++++++@@                 @@.                  -@-                    #@+=@@     
                                                                 @@+++++++@@.                *@-            -@=                                  
                                                                    +@#++++++#@+                .@@       @=                                     
                                                                       .@@++++++*@@                 @@    @+@@.                                  
                                                                           @@+++++++@@                 @@@#@@                                    
                                                                              @@+++++++@@                                                        
                                                                                 *@#++++++@@.                                                    
                                                                                    .@@++++++#@*                                                 
                                                                                        @@+++++@*                                                
