                                                                   @=+%#%@*=%====@@             %@.               -@@+++++++@@                   
                                                                   @=##%=+=*==@@                   =@-                @@+++++++@@:               
                                                                   @====@==@@                         .@#                @@#++++++*@%            
                                                                   .=%+=@@                               .@@                .@@+++++++@@         
                                                                    =@@                                      @@                 @@+++++++@@      
                                                                    @                                           @@                 -@@++++++@@:  
                                   *@@@                             @                                              @@                  @@++++++*@
                                 *##@###                            -#                                                @@.                 @@*++++
                                .###@###@                            @                                                   *@:                 .@@+
                                @###@####                            @                                                      :@+                  
                               .####@####.                           %:                                                        .@@               
                               @####%####.                            @                                                            @@            
                               @####%####.                            @                                                               @@         
                               @#########.                            @.                                                                 @@.     
                               @#########:                            .@                                                                    @@.  
                               @#########:                             @                                                                       #@
                               *#######@@@@.                           @                                                                         
                               =####@@      +@-                        .@                                                                       @
                               :#@@            .@% @@@=@@===+:%=%:@*-@%                                                                      @@++
                               @@@                .@@=@=@%===@=@=@@.                                                                     .@@+++++
                               @+++@@                 @@=##@==@@                                                                      -@%++++++@@
                               @*+++++@@                 @@@@                                                                      %@*++++++@@   
                                 =@#+++++@@                                       :@%**#%@@@@@@@@@@@@@@%=..                     @@+++++++@@      
                                    :@%+++++@@.                                @@====@++++++++++++++++++++++++++++++**#@@@@@@@@++++++*@@         
                                       .@@+++++#@-                      *   @@=======@@@@%#*++++++++++++++++++++++++++++++++++#+++#@=            
                                           @@+++++*@#                :. %@=======+@@                 -+%@@@@@@@@@@@%**++++++++%@@.               
                                              @@+++++*@@          @.  @=@=====@@.                                                                
                                                 @@++++++@@        @====@===@                                                                    
                                                    @@++++++@@ .@==*=%==%===@                                                                    
                                                       @@+++++@====%====#===@                                                                    
                                                          #@*+@====@====%===@                                                                    
                                                             =@====#%===++==@                                                                    
                                                              +*===+=*==+===@                                                                    
                                                              .@======+=====@                                                                    
                                                               @===*====@===@                                                                    
                                                               @=====%======@                                                                    
                                                               @======#====+ @@.                                                                 
                                                               @===+====:       +@-                                                              
                                                               @=====.             :@*                                                           
                                                               @=+                -@#@                                                           
                                                               @@                .@@+@                                                @.         
                                                               @++@@                 @@                                             .+%=*        
                                                               @*++++@@.                @@.                                       *#=+*#+=@      
                                                               :@+++++++%@=                *@=                                  @@==@@ +@*==@   :
