                                                               @@                                         @@                 @@*++++++@@.        
                                                               :@                                            @@                 :@@++++++%@-     
                              @####-                            @                                               @@.                 @@++++++*@%  
                            :######@                            @                                                  @@.                 *@#++++++@
                            @########                           =+                                                    *@:                 .@@++++
                           @####%###@                            @                                                       -@*                  @@*
                           @####@###@                            @                                                          .@@                  
                          .#####@###@                            @:                                                             @@               
                           #####@###@                             @                                                                @@            
                           #####@###@                             @                                                                   @@         
                           %####@###@                             @.                                                                     @@      
                           @####@###@                             .@                                                                        #@.  
                           @####@@@   @@.                          @                                                                         +@@ 
                           @##@@         +@=   . @. @+ @#  .     .@@                                                                      @@+++@ 
                           @%               .@@=+*#=%=*=@==##*+@#                                                                      @@++++++@.
                          .@+@@                 @@+*=#%+=#=@@.                                                                      @@++++++#@+  
                          .@++++@@                 @@=%=@@                                                                      :@%++++++@@.     
                           #@*+++++@@                 +                         @@#-:.                                       %@*++++++@@         
                              +@*+++++@@                                    :@@=%++++++++++++++**#@@@@@@@@@@@@@@%+=.      @@+++++++@@            
                                 :@%+++++@@.                             @@======++++++++++++++++++++++++++++++++++++++++@+++++*@@               
                                    .@@+++++#@-                    #  @@=======@@ .-#@@@@@@@@@@@@#*++++++++++++++++++++++@++#@+                  
                                       .@@+++++*@*            .-.  @=======+@@                             ..=@@@@@@@@@@@@@.                     
                                           @@++++++@@           @=======@@.                                                                      
                                              @@++++++@@     @====+=====@                                                                        
                                                 @@++++++@@====*====@===@                                                                        
                                                    @@++++@=============@                                                                        
                                                       @@*@=============@                                                                        
                                                          @===+====@====@                                                                        
                                                          @====@====%===@                                                                        
                                                          @=====#=======@                                                                        
                                                          @====*==@=====@                                                                        
                                                          @====@===@+===@                                                                        
                                                          @====@%===*#    @@.                                                                    
                                                          #+===#===          *@:                                                                 
                                                          :#===:                @@                                                               
                                                          .@.                @@++@                                                               
                                                           @@@                 @@@                                              @==@             
                                                           @+++@@                 @@                                           @====@            
                                                           @++++++@@.                @@.                                     #+==@@==*%          
                                                            @@+++++++#@-                +@=                                @==@@    =@#=@ #@@    
                                                               *@#++++++*@%                .@@                           @=@@          .@@===@@.@
                                                                  .@@+++++++@@                 @@                      .@@                 @@====
                                                                      @@+++++++@@                 @@                 @@                       %@@
                                                                         @@+++++++@@.                %@:          @@                             
