                                                                                       @+#=#=@              @+++++++@@.                          
                                                                                     %==+=@=*@               =@%+++++++%@:                       
                                                                                   @++=@=#@.   @@                @@+++++++*@%                    
                                                                      .@=.  @@*==@==*@%@.         @@                @@*+++++++@@                 
                                                                       =+==%==@====%@.               @@.               :@@+++++++@@              
                                                                       #@==#=+==@@.                     *@-                @@+++++++@@:          
                                                                       @==#=#@@.                           :@*                *@#++++++*@@       
                                                                       @==@@                                  .@@                 @@+++++++@@    
                                                                       @@.                                       .@@                 @@*++++++@@ 
                                                                       .@                                            @@                 :@@++++++
                                      @####-                            @                                               @@                  @@+++
                                    .######@                            @                                                  @@.                 #@
                                    @###%###@                           -%                                                    *@:                
                                   @####@###@                            @                                                       -@+             
                                   @####@###@                            @                                                          .@@          
                                   #####@###@                            #:                                                             @@       
                                   #####@###@                             @                                                                @@    
                                   %####@###@                             @                                                                   @@ 
                                   %####@###@                             @.                                                                     
                                   @####@###@                              @                                                                     
                                   @####@@@   @@.                          @                                                                     
                                   @##@@         +@=     @  @= @#         @@                                                                     
                                   @@               .@@==#*=@=#=@==%@#=@@                                                                      @@
                                   @*@@                 @@**=#@+=%=%@-                                                                      @@+++
                                   @++++@@                 @@=@=@@.                                                                     .@@++++++
                                   %@*+++++@@                 #                         @@*:..                                       *@#++++++@@ 
                                      +@*+++++@@                                    .@@=#++++++++++++++**%@@@@@@@@@@@@@@%=:.      @@*++++++@@    
                                         -@%+++++@@.                             %@+=====++++++++++++++++++++++++++++++++++++++++@++++++@@       
                                            .@@+++++%@:                    @  @@=======@@ :=#@@@@@@@@@@@@#*++++++++++++++++++++++@++*@#          
                                               .@@+++++*@+            .:.  @========@@                             .:+@@@@@@@@@@@@@:             
                                                   @@+++++*@@           @=======@@:                                                              
                                                      @@++++++@@     @==========@                                                                
                                                         @@++++++@@====#====@===@                                                                
                                                            @@++++@======+======@                                                                
                                                               @@*@=======+=====@                                                                
                                                                  @===*====%====@                                                                
                                                                  @====%====@===@                                                                
                                                                  @====+*===+===@                                                                
                                                                  @====#==#=+===@                                                                
                                                                  @====@===@*===@                                                                
                                                                  @====@@===*@    @@.                                                            
                                                                  **===#==*          #@:                                                         
                                                                  .@===-                @@                                                       
                                                                  .@.                @@++@                                                       
