                                                                                      @%=+@+*.              @+++++++*@%                          
                                                                                    .@=+=%=+@@.               @@++++++++@@                       
                                                                              . ..@==#@=+@=    =@-               *@#+++++++@@                    
                                                                      @==..@@+==*==#=*@-          .@#               .@@+++++++@@:                
                                                                      -=%=#==@==+=*@:                .@@                @@*++++++*@@             
                                                                       @==%====*@:                       @@                -@@+++++++@@          
                                                                       #=*==@@.                             @@                 @@+++++++@@       
                                                                       @=@@.                                   @@                 #@#++++++@@:   
                                                                       @.                                         @@.                .@@++++++*@%
                                        :.                             @-                                            +@-                 @@++++++
                                     @#%###-                            @                                               :@#                 -@@++
                                    @######@                            @                                                  .@@                  @
                                   .########:                           @.                                                     @@                
                                   @########@                           .@                                                        @@             
                                   #########@                            @                                                           @@          
                                  -#####%###@                            @                                                              @@.      
                                  .#####%###@                            .@                                                                *@:   
                                  .#####@###@                             @                                                                   :@*
                                   #####@###@                             @                                                                      
                                   #####@##@@+                            -*                                                                     
                                   %####@@.   .@@                          @                                                                     
                                   %#@@           @@   @ @% #@@%:.@@     @@                                                                      
                                  +@                 @@=%=%==*=@==#=@=@@                                                                      @@+
                                  #*+@@.                @@==%=+=#=#@=                                                                      @@++++
                                  =#++++@@.                -@#=@@                                                                      .@@++++++#
                                    @@+++++#@-                                         @@@@@@@@@#=:.                                =@#++++++@@. 
                                       @@+++++*@%                                  .@@==@+++++++++++++++++++++*#%@@@@@@@@@@@@@@#-@@*++++++@@     
                                          @@++++++@@                       .    +@*=====#++++++++++++++++++++++++++++++++++++++++@+++++@@        
                                             @@++++++@@               =   @  @@=======@@       .-%@@@@@@@@@@@@%#+++++++++++++++++@+*@@           
                                                @@++++++@@            %.  @+=======@@                                   ..=#@@@@@@=              
                                                   %@*+++++@@         =@+=======@-                                                               
                                                      *@*+++++@@.   @+=========**                                                                
                                                         -@#+++++#@===#====@===**                                                                
                                                            .@@+++@=====+===+==*+                                                                
                                                               .@@@============*+                                                                
                                                                  @=======@====*=                                                                
                                                                  @===@====@===*=                                                                
                                                                  @====*=======*-                                                                
                                                                  @======*=====#-                                                                
                                                                  @=======#====#@#                                                               
                                                                  @====@====@     .@@                                                            
                                                                  @====#=#            @@                                                         
                                                                  @====                @@%                                                       
                                                                  %.                #@++*@                                                       
