                                                                @#==@@                                 @@.                %@#++++++#@=           
                                                                .@@                                       +@-                .@@++++++*@@        
                                                                 @                                           :@*                 @@*++++++@@     
                               :@%#@:                            @                                              .@@                 -@@++++++@@. 
                              @##@##%                            @                                                  @@                  @@++++++%
                             @###@###@                           .@                                                    @@                  %@*+++
                            .####@###@                            @                                                       @@                  .@@
                            @####@###@                            @                                                          @@.                 
                            @####@###@                            :#                                                            *@:              
                            @####@###%                             @                                                               -@*           
                            @####@###%                             @                                                                  .@@        
                            @####@###%                             ++                                                                     @@     
                            @####@####                              @                                                                        @@  
                            @######@@  @@                           @                                                                          @@
                            @###@@        @@      .  =   -         .@.                                                                      @@++@
                            @@=              @@.@=*==@=%=#@+=@@+%@-                                                                     .@@+++++*
                            @@@.                +@+*#=**=+%*=@@                                                                      :@@++++++@@:
                            @+++#@-                .@%=+==@@                                                                      *@*++++++@@.   
                            @@+++++*@#                 @%                                                                      @@+++++++@@       
                               @@++++++@@                                     +@*-+++++++++*#%@@@@@@@@@@@@@@*-:             @@+++++++@@          
                                  @@++++++@@                               @@=====*++++++++++++++++++++++++++++++++++++++**++++++*@*             
                                     @@++++++@@                      +  @@=======@@@@@@@@@@@@%**++++++++++++++++++++++++++*+++@@:                
                                        %@*+++++@@               +  .@=======#@=                        .-%@@@@@@@@@@@@#*+*@@                    
                                           =@*+++++@@.           .@=======@@                                                                     
                                              :@%+++++%@:     .@====*====@                                                                       
                                                 .@@+++++*@*@====+=======@                                                                       
                                                     @@++++@======+==+===@                                                                       
                                                        @@+@===@=====*===@                                                                       
                                                           @====*====@===@                                                                       
                                                           @====#@===#===@                                                                       
                                                           @====@=%==@===@                                                                       
                                                           @====%===@@===@                                                                       
                                                           ++===**===@===@                                                                       
                                                           -%===+=+==%=-   @@                                                                    
                                                           .@=======.         @@                                                                 
                                                            @===+                @@                                                              
                                                            @*                *@*+@                                                              
                                                            @@-                %@*@                                              -@%@            
                                                            @++*@@                -@*                                           =@=#@@           
                                                            @++++++@@                .@@                                       @*==@=@=@         
                                                            .@@+++++++@@                 @@                                 @%==@#   @@==@  @@   
                                                                @@+++++++@@.                @@.                           @==@#         @@+=%@@: 
                                                                   @@+++++++%@-                =@+                       @@%               .@@==%
                                                                      =@#++++++*@@                .@@                 .@#                      @@
