                  @####%####                             @                                                                  @@.                  
                  @#########.                            .@                                                                    *@:               
                  @#########.                             @                                                                       -@+            
                  @#######@#*@:                           @                                                                          .@:         
                  @###%@-      :@#                        *+                                                                       @@+*#         
                  +@@.            .@@ @@@=@@===*@*=-%@+@@.                                                                     .@@+++++@         
                  @@@                 @@=*=@+===%=+=@@                                                                      *@*++++++@@          
                  @+++@@                 @@=*@*==@@                                                                      @@+++++++@@             
                  @#+++++@@.                #@@-                                                                      @@++++++*@@                
                    :@%+++++@@.                                      @@=+++*#%@@@@@@@@@@@@@@%=:.                  .@@++++++*@+                   
                       .@@+++++#@-                                @@====%++++++++++++++++++++++++++++++++**#@@@@@%++++++@@.                      
                           @@+++++*@#                      -  .@@=======@@@@@@@#*++++++++++++++++++++++++++++++++*+++@@                          
                              @@++++++@@                @  *@=======@@.                  .:*@@@@@@@@@@@@%**++++++*@@                             
                                 @@++++++@@          .. -@=*=====@@                                                                              
                                    @@++++++@@       =@====@===@                                                                                 
                                       @@++++++@@ =@==+====%===@                                                                                 
                                          %@*++++@====*==#=@===@                                                                                 
                                             =@#+@====%===+@===@                                                                                 
                                                :@====@====@*==@                                                                                 
                                                 @====%=@==#===@                                                                                 
                                                 **===*==@=*===@                                                                                 
                                                 .@========#===@                                                                                 
                                                 .@============@                                                                                 
                                                  @===========. +@-                                                                              
                                                  @=======+        :@*                                                                           
                                                  @====#              .@@                                                                        
                                                  @=@                @@+@                                                                        
                                                  @@                 @@+@                                               +@-                      
                                                  @++@@.                @@                                             #@%=@                  @@=
                                                  @+++++%@:                @@:                                       @@%=%+==@              =@@=%
                                                  =@*++++++*@%                :@@                                  @@=%@. :@@==@  .*     .@*@==#=
                                                     -@%+++++++@@                 @@                            .@=#@.        @@#*@=@   ===+==@@-
                                                        .@@+++++++@@                 @@                        @%@.              @@==*==+==@@    
                                                            @@+++++++@@.                @@.                  *@.                    +@**@#       
                                                               @@*++++++%@:                -@+            +@.                                    
                                                                  -@%++++++*@#                .@@       @.                                       
                                                                      @@+++++++@@                 @@   .@+@@.                                    
                                                                         @@+++++++@@                 @@@%@#                                      
                                                                            @@*++++++@@.                                                         
                                                                               =@#++++++%@:                                                      
                                                                                  .@@++++++*@#                                                   
                                                                                      @@++++*@-                                                  
                                                                                         @@#                                                     
                                                                                          @+@@                                                   
