                   @####@####                             @                                                               @@                   =@
                   @####%####                             @                                                                  @@.                 
                   @#########.                            .@                                                                    *@-              
                   @#########.                             @                                                                       :@#           
                   @######%@++@=                           @                                                                          .@.        
                   @###@@.      .@@                        @+                                                                      .@@+**        
                   *@@              @@ @%%=@@===*@*=:@@=@@                                                                      -@#+++++@        
                   @@@                 @@=*=%+==+@===@@                                                                      %@*++++++@@         
                   @+++@@                 @@=*@+=+@#                                                                      @@+++++++@@            
                   @%+++++@@                 +@@.                                                                      @@++++++*@%               
                     .@@+++++@@.                                      @@=+++**#%@@@@@@@@@@@@@@#=.                  .@@++++++%@:                  
                         @@+++++#@=                               .@@====#++++++++++++++++++++++++++++++++++*#%@@@#++++++@@                      
                            @@+++++*@%                      :  -@%======*@@@@@@@#*++++++++++++++++++++++++++++++++++++@@                         
                               @@++++++@@                %  %@=======@@.                  ..=@@@@@@@@@@@@@%*++++++*@@                            
                                  @@++++++@@          .  *%=*=====@@                                                                             
                                     @@++++++@@       *%====@===@                                                                                
                                        %@*+++++@@.%%===+===%===@                                                                                
                                           +@*++++@====+==@=@===@                                                                                
                                              -@#+@====#===*@===@                                                                                
                                                 .@====@====@*==@                                                                                
                                                  @====@=%==%===@                                                                                
                                                  #+===*==@=#===@                                                                                
                                                  :#===+====*===@                                                                                
                                                  .@========+===@                                                                                
                                                   @=====+==+=+  =@=                                                                             
                                                   @=======#        .@%                                                                          
                                                   @====@              .@@                                                                       
                                                   @=%                @@+@                                                                       
                                                   @@                 @@+@                                               @@=                     
                                                   @++@@.                @@                                             @@%=@                 .@@
                                                   @+++++%@-                *@-                                       @@@=@=+=@             .=#@=
                                                   -@*++++++*@@                .@@                                  @@=@@. .@@==@  .#     =@=@==@
                                                      .@@+++++++@@                 @@                            .@=%@.        @@*+%=@   %==*==@@
                                                          @@+++++++@@                 @@                        @@@               @@==+=====@@   
                                                             @@+++++++@@.                @@:                  @@.                    -@##@=      
                                                                @@*++++++#@-                :@#            @@.                                   
                                                                   :@@++++++*@@                 @@       @.                                      
                                                                       @@+++++++@@                 @@   .@+@@:                                   
                                                                          @@+++++++@@                 @@@@@=                                     
                                                                             @@*++++++@@.                                                        
                                                                                :@%++++++#@=                                                     
                                                                                   .@@++++++*@@                                                  
                                                                                       @@++++#@.                                                 
                                                                                          @@+                                                    
