                      ####@####.                           +=                                                        -@=                  @@*++++
                     @#########.                            @                                                           .@%                  .@@+
                     @#########.                            @                                                               @@                   
                     @#########:                            @.                                                                 @@                
                     @#########=                             @                                                                    @@             
                     @#########+                             @                                                                       @@.         
                     =#######@@@@                            @.                                                                         @@:      
                     :####@@.     @@.                        .@                                                                       =@#+@      
                     .#@@            +@- #@@=@*=+== @#@ @% @@                                                                      @@*++++@      
                     @@*                .@@=#=+@=*=*=+=#@@                                                                      @@+++++++@@      
                     @++*@@                .@@======@@:                                                                      @@++++++*@#         
                     @++++++@@                 @@@@                                                                      .@@++++++%@:            
                       @@++++++@@                                        @@%@@@@@@@@@@@@@@%*-..                       *@*++++++@@.               
                          *@*+++++@@                                 :@%===@++++++++++++++++++++++++++++*#%@@@@@@@@@@+++++++@@                   
                             -@#+++++@@.                      %   %@+======@@%#*++++++++++++++++++++++++++++++++++++%++++@@                      
                                .@@+++++%@:              .  * %@@=======@@              .:*@@@@@@@@@@@@%#*++++++++++@*@%                         
                                   .@@+++++*@+          +:  @+%=====+@%                                           .-.                            
                                       @@+++++*@%        @====#@==@.                                                                             
                                          @@++++++@@  @==%=#==#===@                                                                              
                                             @@+++++@====@===@*===@                                                                              
                                                @@++@====#====%===@                                                                              
                                                   @@+===*#=======@                                                                              
                                                    -%======*=====@                                                                              
                                                     @=======#====@                                                                              
                                                     @===@====+===@                                                                              
                                                     @=====#======@                                                                              
                                                     @======%====% @@                                                                            
                                                     @===@====@       @@.                                                                        
                                                     @=====*             %@.                                                                     
                                                     @==-                @@@                                                                     
                                                     @@                -@%+@                                                %                    
                                                     @++@@                .@@                                              =%=+                  
                                                     *#++++@@                 @@                                        .#=@=@#+@              @=
                                                     :@+++++++@@.                @@.                                  -@==@@ @@==*@          :@+@
                                                        @@+++++++%@=                +@=                             @+=@@       -@#*@==@    @==#=
                                                           +@#++++++*@@                .@@                         @@@              @@==%=++===@@
                                                              .@@+++++++@@                 @@                    @@                    @@==@@.   
                                                                  @@+++++++@@                 @@.             @@                                 
                                                                     @@+++++++@@.                *@:       @@                                    
                                                                        +@#++++++#@-                .@%    @+@@                                  
                                                                           .@@++++++*@@                .@@-%@@.                                  
                                                                               @@+++++++@@                                                       
                                                                                  @@+++++++@@                                                    
                                                                                     *@*++++++@@.                                                
