                                                                                 @+#==+=@@  .@#               #@#+++++++@@                       
                                                                     *@    @=@=+@==%=@@         @@                @@+++++++%@=                   
                                                                     **===@=+*=+==@@               @@                @@*++++++*@@                
                                                                     @=*=%==%=+@@                     @@                :@@+++++++@@             
                                                                     @+==@#=@@                           @@                 @@+++++++@@.         
                                                                     @#==@@                                 @@.                #@#++++++#@=      
                                                                     .@@                                       +@-                .@@++++++*@@   
                                                                      @                                           :@*                 @@*++++++@@
                                    :@@#@:                            @                                              .@@                 -@@+++++
                                   @##@##%                            @                                                 .@@                  @@++
                                  @###@###@                            @                                                    @@                  %
                                  ####@###@                            @                                                       @@                
                                 @####@###@                            @                                                          @@.            
                                 @####@###@                            :%                                                            *@:         
                                 @####@###%                             @                                                               :@*      
                                 @####@###%                             @                                                                  .@@   
                                 @####@####                             ++                                                                     @@
                                 @####%####                              @                                                                       
                                 @######@@  @@                           @                                                                       
                                 @###@@        @@      .  =   -         .@.                                                                      
                                 @@+              @@.@=*==@=#=*@+=@@*@@=                                                                      @@+
                                 @@@.                +@+*#=**=+%*=@@.                                                                     .@@++++
                                 @+++#@-                .@%=+==@@                                                                      *@*++++++@
                                 @@+++++*@%                 @%                                                                      @@+++++++@@  
                                    @@++++++@@                                     +@*-+++++++++*#%@@@@@@@@@@@@@@*-:             @@+++++++@@     
                                       @@++++++@@                               @@=====*++++++++++++++++++++++++++++++++++++++**++++++*@#        
                                          @@*+++++@@                      +  @@=======@@@@@@@@@@@@%**++++++++++++++++++++++++++*+++@@:           
                                             #@*+++++@@               +  .@=======#@+                        .-#@@@@@@@@@@@@#*+*@@               
                                                =@#+++++@@.           .@=======@@.                                                               
                                                   :@%+++++#@-     .@====*====@                                                                  
                                                      .@@+++++*@*@====+=======@                                                                  
                                                         .@@++++@=========+===@                                                                  
                                                             @@+@===@=====*===@                                                                  
                                                                @====*====@===@                                                                  
                                                                @====#@===%===@                                                                  
                                                                @====@=%==@===@                                                                  
                                                                @====%===@@===@                                                                  
                                                                =*===**===@===@                                                                  
                                                                :%===+=+==%=-   @@                                                               
                                                                 @=======.         @@                                                            
                                                                 @====                @@                                                         
                                                                 @*                *@*+@                                                         
                                                                 @@-                %@*@                                              -@%@       
                                                                 @++*@@                :@#                                           =@=#@@      
