                          .%#@###                            :%                                                @@                  @@++++++*@@   
                          ###@###@                            @                                                   @@.                 =@%++++++@@
                         @###@####                            @                                                      #@.                  @@+++++
                         ####@####.                           =+                                                        -@=                  @@*+
                        %#########.                            @                                                           .@%                  .
                        @#########:                            @                                                               @@                
                        @#########:                            @.                                                                 @@             
                        %#########=                             @                                                                    @@          
                        ##########+                             @                                                                       @@       
                        =#######@@@@                            @.                                                                         @@:   
                        :####@@.     @@.                        .@                                                                       -@%+@   
                        .#@@            +@- *@@=@+=*== @#@ @% @@                                                                      @@*++++@   
                        @@*                .@@=#=+@=*=+=+=#@@                                                                      @@+++++++@@   
                        @++*@@                 @@====+=@@:                                                                      @@++++++*@%      
                        @++++++@@                 @@@@                                                                      .@@++++++%@-         
                          @@++++++@@                                        @@%@@@@@@@@@@@@@@%+-..                       *@#++++++@@.            
                             *@*+++++@@                                 .@@===@++++++++++++++++++++++++++++*#%@@@@@@@@@@+++++++@@                
                                -@#+++++@@.                      @   %@+======@@%#*++++++++++++++++++++++++++++++++++++%++++@@                   
                                   .@@+++++%@:              .  * %@@=======@@              .:#@@@@@@@@@@@@%#*++++++++++@*@%                      
                                      .@@+++++#@+          =:  @+%=====+@%                                           .-:                         
                                          @@+++++*@@        @+===#@==@.                                                                          
                                             @@++++++@@  @==@=#==*===@                                                                           
                                                @@+++++@====@===@*===@                                                                           
                                                   @@++@====#====%===@                                                                           
                                                      @@+===+*=======@                                                                           
                                                       :%======#=====@                                                                           
                                                        @=======#====@                                                                           
                                                        @===@====+===@                                                                           
                                                        @=====#======@                                                                           
                                                        @======%====% @@                                                                         
                                                        @===@====@       @@.                                                                     
                                                        @=====*             %@.                                                                  
                                                        @==-                @@@                                                                  
                                                        @@                -@%+@                                                #                 
                                                        @++@@                .@@                                              =#==               
                                                        *#++++@@                 @@                                        .#=@=@#+@             
                                                        :@+++++++@@.                @@.                                  :@==@@ @@==*@   .      :
                                                           @@+++++++%@=                +@=                             @*=@@       -@#*@==@    @=
                                                              +@#++++++*@@                .@@                         @@@              @@==%=++==
                                                                 .@@+++++++@@                 @@                    @@                    @@=+@@.
                                                                     @@+++++++@@                 @@.             @@                              
                                                                        @@+++++++@@.                *@:       @@                                 
                                                                           +@#++++++#@-                :@%    @+@@                               
                                                                              .@@++++++*@@                 @@:%@@:                               
