               .#####@##@@@                            #:                                                                         @@             
                #####@@     @@                          @                                                                        @@+@            
                ##@#           @@.  @.#@.=@@=.@@@  : =@#                                                                      @@++++@            
               @@.                %@++=%==@+==%=%#@@.                                                                     .@@++++++%@            
               @++@@.                -@#=%==#==@@                                                                      =@#++++++@@.              
               @+++++#@=                .@@=@@                                                                      @@*++++++@@                  
                 @@+++++*@@                                        -@@@@@@@@@@@@#-:.                             @@+++++++@@                     
                    @@++++++@@                                  @@===@+++++++++++++++++++++++**#@@@@@@@@@@@@@@@@++++++*@@                        
                       @@++++++@@                       +    @@======@*+++++++++++++++++++++++++++++++++++++++@++++%@-                           
                          @@*+++++@@               =  ..-.@+======+@@          :=@@@@@@@@@@@@%#*++++++++++++++@+@@.                              
                             #@*+++++@@            @   @+======@@.                                      ..*@@@@                                  
                                =@#+++++%@.        @@=======@@                                                                                   
                                   .@%+++++#@=  .@=#==@=====@.                                                                                   
                                      .@@+++++%+===*========@.                                                                                   
                                          @@++*#====%====%==@.                                                                                   
                                             @@@=====@======@.                                                                                   
                                               @============@.                                                                                   
                                               @============@.                                                                                   
                                               @====#=======@.                                                                                   
                                               @======#=====@.                                                                                   
                                               @=======*====-@@                                                                                  
                                               @=========.      @@                                                                               
                                               @======             @@                                                                            
                                               @==+                =@%=                                                                          
                                               @.                @@++#=                                                                          
                                               *##@+                +@*                                              +==*                    @%@ 
                                               .@+++*@@                .@@                                         @=#==#@#              @==+==@@
                                                @+++++++@@                 @@                                    .@==@#@@=#@%           #==*====%
                                                  @@+++++++@@                 @@                               @==@*      @@=@@+=%    %*==@==@@=#
                                                     @@+++++++@@.                @@:                         +=@#            +@*=+=+@=%==@@:    @
                                                        %@*++++++#@+                :@%                    .@#                  .@@=%=@@         
                                                           :@%++++++*@@                 @@              .@*                         +            
                                                              .@@+++++++@@                 @@        .@#                                         
                                                                  @@+++++++@@                 @@.    @#@@                                        
                                                                     @@*++++++@@.                -@+ @+@@                                        
                                                                        :@%++++++#@+                .:                                           
                                                                            @@++++++*@@                                                          
                                                                               @@+++++++@@                                                       
                                                                                  @@*++++++@                                                     
                                                                                     -@%@@                                                       
                                                                                       @@@                                                       
                                                                                       @+++%@+                                                   
                                                                                       @+++++++@@                                                
                                                                                        @@++++++++@@                                             
