                                                                     %.    @#@+=*=*==@@       #@.               %@*+++++++@@                     
                                                                    @=%+=%+*===@==@@             =@=               .@@+++++++@@.                 
                                                                    @=+=%+==@+=@@                   .@#                @@+++++++#@*              
                                                                    @=%==*==@@                          @@                -@@+++++++@@           
                                                                    :====@@                                @@                 @@+++++++@@        
                                                                     =@@                                      @@                 @@*++++++@@.    
                                                                     @                                           @@                 .@@++++++#@* 
                                    @@#@                             @                                              @@.                 @@+++++++
                                  @##@###                            *-                                                +@-                 =@@+++
                                 :###@###@                            @                                                   :@#                  @@
                                 @###@###%                            @                                                      .@@                 
                                :####@####                            @.                                                         @@              
                                @####@####                             @                                                            @@           
                                @####%####                             @                                                               @@.       
                                @####%####                             @                                                                  @@.    
                                @#########.                            .@                                                                    *@: 
                                @#########.                             @                                                                       :
                                @#######@%*@-                           @                                                                        
                                @###%@-      :@%                        +#                                                                       
                                =@@.            .@@ @%@=@@===+@#==@@#@@.                                                                     .@@+
                                @@@                 @@=*=@*===%=+=@@                                                                      +@#++++
                                @+++@@                 @@=#@*==@@                                                                      @@*++++++@
                                @#+++++@@.                *@@=                                                                      @@+++++++@@  
                                  .@@+++++@@.                                      @@=*++**%@@@@@@@@@@@@@@%=:.                  .@@++++++*@+     
                                     .@@+++++#@=                                @@====@++++++++++++++++++++++++++++++++**#@@@@@@++++++@@.        
                                         @@+++++*@%                      -  .@@=======@@@@@@@#*++++++++++++++++++++++++++++++++*+++@@            
                                            @@++++++@@                %  *@=======@@:                  .:*@@@@@@@@@@@@%**++++++*@@               
                                               @@++++++@@          .. -@=#=====@@                                                                
                                                  @@++++++@@       -@====@===@                                                                   
                                                     @@*+++++@@ =@==+====@===@                                                                   
                                                        #@*++++@====*==#=@===@                                                                   
                                                           -@#+@====@===+@===@                                                                   
                                                              .@====@====%#==@                                                                   
                                                               #====#=@==#===@                                                                   
                                                               +*===+==@=*===@                                                                   
                                                               .@========*===@                                                                   
                                                               .@============@                                                                   
                                                                @===========. =@-                                                                
                                                                @=======+        :@#                                                             
                                                                @====#              .@@                                                          
                                                                @=@                @@+@                                                          
                                                                @@                 @@+@                                               +@=        
                                                                @++@@.                @@                                             *@#=@       
                                                                @+++++%@-                %@:                                       @@%=%===@     
