                                                                                     @==+==@%              .@%+++++++#@=                         
                                                                                   @=@====@@ @@                @@++++++++@@                      
                                                                       -.    @@@#=@=+==@@       @@.               @@*+++++++@@                   
                                                                      @=#*+%#*=+=#==@@             *@:               .@@+++++++@@.               
                                                                      @=*+%===@==@@                   :@*                @@+++++++#@=            
                                                                      @=*==@==@@                         .@@                +@%++++++*@@         
                                                                      .=*==@@                               .@@                .@@+++++++@@      
                                                                       =@@                                      @@                 @@*++++++@@.  
                                                                       @                                           @@                 :@@++++++#@
                                      @@%@                             @                                              @@.                 @@+++++
                                    @##@###                            =+                                                *@:                 +@#+
                                   .###@###@                            @                                                   -@+                 .
                                   @###@####                            @                                                      .@@               
                                  .####@####.                           @:                                                         @@            
                                  @####@####.                            @                                                            @@         
                                  @####%####.                            @                                                               @@      
                                  @#########.                            @.                                                                 @@   
                                  @#########.                            .@                                                                    %@
                                  @#########.                             @                                                                      
                                  ########@@@@:                           @                                                                      
                                  *####@#      -@#                        :@                                                                     
                                  -%@-            .@@ @@@=@@===++#=*+@##@-                                                                      @
                                  @@@                 @@=%=@#===%=%=@@                                                                      :@@++
                                  @+++@@                 @@=%@%==@@                                                                      @@*+++++
                                  @#+++++@@                 @@@%                                                                      @@+++++++@@
                                    :@%+++++@@.                                      #@+*+**%@@@@@@@@@@@@@@#+:..                   @@+++++++@@   
                                       .@@+++++%@:                                @@====@++++++++++++++++++++++++++++++++*#%@@@@@@++++++#@+      
                                           @@+++++*@+                      +   @@=======@@@@@%#*+++++++++++++++++++++++++++++++++*+++@@.         
                                              @@+++++*@@                +. *@=======%@+                 .:*%@@@@@@@@@@@@#*+++++++#@@             
                                                 @@++++++@@          =. .@=%=====@@                                                              
                                                    @@++++++@@       .@====@===@                                                                 
                                                       @@++++++@@ .@==*=*==@===@                                                                 
                                                          %@*++++@====#==+=%===@                                                                 
                                                             +@*+@====@====%===@                                                                 
                                                                :@====%*===*#==@                                                                 
                                                                 *+===*=%==*===@                                                                 
                                                                 -#===+==#=+===@                                                                 
                                                                 .@========%===@                                                                 
                                                                  @=====+======@                                                                 
                                                                  @======+====: %@:                                                              
                                                                  @========.       -@=                                                           
                                                                  @====+              .@#                                                        
                                                                  @=#                @@*@                                                        
                                                                  @@                 @@+@                                               :@-      
