               @#######@@@@.                           @                                                                          .@:            
               @###%@+      -@*                        =*                                                                       @@+*%            
               +@@.            .@@ @@@=@@===*%*=-*@+@@.                                                                     .@@+++++@            
               @@@                 @@=%=@*===%=*=@@                                                                      =@#++++++@@.            
               @+++@@                 @@=#@#==@@                                                                      @@*++++++@@                
               @#+++++@@                 @@@+                                                                      @@+++++++@@                   
                 :@%+++++@@.                                      @@=+++*#@@@@@@@@@@@@@@@*:..                  .@@++++++*@%                      
                    .@@+++++%@:                                @@====@++++++++++++++++++++++++++++++++**%@@@@@@++++++%@-                         
                        @@+++++*@+                      -  .@@=======@@@@@@#*+++++++++++++++++++++++++++++++++*+++@@.                            
                           @@+++++*@@                #  +@=======@@-                 ..+#@@@@@@@@@@@@#**++++++*@@                                
                              @@++++++@@          :  :@=#=====@@                                                                                 
                                 @@++++++@@       :@====@===@                                                                                    
                                    @@++++++@@ :@==+=+==%===@                                                                                    
                                       @@*++++@====*==*=@===@                                                                                    
                                          *@*+@====@====@===@                                                                                    
                                             -@====@+===%*==@                                                                                    
                                              %====#=@==#===@                                                                                    
                                              +*===*==@=*===@                                                                                    
                                              .@========#===@                                                                                    
                                              .@============@                                                                                    
                                               @===========. #@.                                                                                 
                                               @=======+        -@=                                                                              
                                               @====*              .@#                                                                           
                                               @=%                @@*@                                                                           
                                               @@                 @@+@                                               -@:                         
                                               @++@@.                @@                                             +%%=@                  %@==% 
                                               @+++++@@.                @@.                                       @@#=%+==@              =@@=#===
                                               =@*++++++*@*                -@*                                  @@=*@: -@#==@   =     .@#@==*===#
                                                  =@%+++++++@@                .@@                            .@=*@:       .@@%#@=@   -===+=%@+@@=
                                                     .@@+++++++@@                 @@                        @%@-              @@==#==*==@@       
                                                         @@+++++++@@                 @@.                  =@:                    #@*+@@          
                                                            @@*++++++%@.                +@-            =@-                                       
                                                               =@#++++++*@+                .@@       @-                                          
                                                                  .@@+++++++@@                 @@    @+@@.                                       
                                                                      @@+++++++@@                 @@@#@@                                         
                                                                         @@+++++++@@                                                             
                                                                            *@#++++++@@.                                                         
                                                                               .@@++++++#@+                                                      
                                                                                   @@++++*@+                                                     
                                                                                      @@@                                                        
                                                                                       @+@@                                                      
                                                                                       @++++@@                                                   
                                                                                       @+++++++#@#                                               
                                                                                        -@%++++++++@@                                            
