                                                                  @=**%===#+=@@                   -@=                @@+++++++@@-                
                                                                  @=+==@==@@                         .@@                *@#++++++*@@             
                                                                  .=#==@@                                @@                .@@+++++++@@          
                                                                   =@@                                      @@                 @@+++++++@@.      
                                                                   @                                           @@                 -@@++++++%@:   
                                  %@%@                             @                                              @@                  @@++++++*@@
                                %##@###                            -*                                                %@.                 %@#+++++
                               .###@###@                            @                                                   =@-                 .@@++
                               @###@####                            @                                                      :@*                  @
                              .####@####                            @:                                                        .@@                
                              @####@####                             @                                                            @@             
                              @####%####                             @                                                               @@          
                              @#########.                            @.                                                                 @@       
                              @#########.                             @                                                                    @@.   
                              @#########.                             @                                                                       *@:
                              ########@@@@.                           @                                                                          
                              +####@@      =@+                        .@                                                                       @@
                              -%@*            .@@ @@@=@@===+-%=#-@*+@+                                                                      @@+++
                              @@@                 @@=%=@#===@=@=@@.                                                                     .@@++++++
                              @+++@@                 @@=#%@==@@                                                                      +@#++++++@@.
                              @*+++++@@                 @@@@                                                                      @@+++++++@@    
                                -@#+++++@@                                       =@#***#@@@@@@@@@@@@@@@+:.                     @@+++++++@@       
                                   .@%+++++@@.                                @@====@+++++++++++++++++++++++++++++++*#%@@@@@@@++++++*@@          
                                       @@+++++#@-                      +   @@=======@@@@@%**+++++++++++++++++++++++++++++++++#+++%@:             
                                          @@+++++*@#                -  #@=======*@#                 :-%@@@@@@@@@@@@#*++++++++#@@.                
                                             @@++++++@@          *. .@=@=====@@.                                                                 
                                                @@++++++@@       .@====@===@                                                                     
                                                   @@++++++@@ .@==*=#==@===@                                                                     
                                                      @@+++++@====%====%===@                                                                     
                                                         *@*+@====@====%===@                                                                     
                                                            =@====##===**==@                                                                     
                                                             +*===*=#==+===@                                                                     
                                                             :%======*=+===@                                                                     
                                                              @===+====@===@                                                                     
                                                              @=====#======@                                                                     
                                                              @======*====- @@.                                                                  
                                                              @========.       +@-                                                               
                                                              @=====              :@*                                                            
                                                              @=*                +@#@                                                            
                                                              @@                .@@+@                                               .@:          
                                                              @++@@                 @@                                             :*#=*         
                                                              @+++++@@.                @@.                                       @%+=**==@       
                                                              :@+++++++#@=                +@=                                  @@==@# +@#==@   - 
                                                                 +@#++++++*@@                .@@                             @==@*       .@@@%#=@
