                                                                                    @=@====@@               .@@+++++++*@@                        
                                                                             .   *=%#+==@@    @@.               @@*+++++++@@                     
                                                                     *+=. :@=+==*=%=#@@          +@-               -@@+++++++@@.                 
                                                                     .@#=======@==@@                :@*                @@+++++++%@-              
                                                                      +==#==#==@@                      .@@                %@#++++++*@@           
                                                                      @==+=*@@                             @@                .@@+++++++@@        
                                                                      @==@@                                   @@                 @@+++++++@@     
                                                                      @%                                         @@                 -@@++++++%@- 
                                                                      -+                                            @@.                 @@++++++*
                                    .@####-                            @                                               #@:                 @@*+++
                                   @######@                            @                                                  -@+                 .@@
                                   ########+                           @:                                                    .@@                 
                                  @########@                            @                                                        @@              
                                  %####%###@                            @                                                           @@           
                                 .#####@###@                            @.                                                             @@        
                                  #####@###@                            .@                                                                @@.    
                                  #####@###@                             @                                                                   #@: 
                                  #####@###@                             @                                                                      =
                                  %####@###@.                            .@                                                                      
                                  %####@@+   -@+                          @                                                                      
                                  @#@@.         .@@   * @: @@*@- .#     %@:                                                                     .
                                 .@.                @@=@=%====+==%=@=@@                                                                      -@%+
                                 =%+@@                 @@==+=@=%==@@                                                                      @@*++++
                                 :@++++@@.                @@=*+@#                                                                      @@+++++++@
                                  .@%+++++@@.                                         %@@@@@@*:.                                    @@++++++*@%  
                                     .@@+++++%@-                                   @@==@++++++++++++++++++**%@@@@@@@@@@@@@@#=-. .@@++++++%@-     
                                         @@+++++*@*                            .@@=====+++++++++++++++++++++++++++++++++++++++++@+++++@@.        
                                            @@+++++*@@               .   -  =@=======#@=    .-#@@@@@@@@@@@@#**++++++++++++++++++@++@@            
                                               @@++++++@@            =*  -@=======@@.                                ..=%@@@@@@@@@               
                                                  @@++++++@@         :-@=======@@                                                                
                                                     @@++++++@@    =@-===%=====@                                                                 
                                                        %@*+++++@@===#=========@                                                                 
                                                           =@*+++@=====@=======@                                                                 
                                                              :@%@======@======@                                                                 
                                                                 @=======+=====@                                                                 
                                                                 @========+====@                                                                 
                                                                 @=====+=======@                                                                 
                                                                 @=============%                                                                 
                                                                 @====+========@:                                                                
                                                                 @====#====+     :@+                                                             
                                                                 @====@=*           .@@                                                          
                                                                 @===%                @@@                                                        
                                                                 -*                -@+++@                                                        
                                                                  @@@                 @@@                                              @==@.     
