                                                                                         @@                                      @@=%%=@=+==@=+@@
                                                                                      @@                                            @@=====@@.   
                                                                                   @@                                                  #@@       
                                                               :@               @@                                                               
                                                              @=@              @@                                                                
                                                             :*=@              @++@@.                                                            
                                                           @=+=%@              @+++++*@*                                                         
                                                         @===*=%@              +@++++++++@@                                                      
                                                       =@===@=*@=@=               @@*+++++++@@                                                   
                                                 @@@@@+==#=#@.     .@#               :@@+++++++@@.                                               
                                          %=@@@=#==%==+=@@.           .@@                @@+++++++*@#                                            
                                          @==@==@==@=%@.                  @@                #@#+++++++@@                                         
                                          @+=*=+==%@.                        @@                .@@+++++++@@                                      
                                          *=%==@@                               @@.                @@*++++++@@.                                  
                                          .=@@.                                    @@.                -@@++++++#@*                               
                                           @                                          +@-                 @@+++++++@@                            
          .@@@                             @                                             :@#                 #@*++++++@@                         
        =##@##@                            @.                                               .@@                 .@@++++++@@.                     
       .###@###@                           .@                                                   @@                  @@++++++#@#                  
       @###@###@                            @                                                      @@                  =@@++++++@@              @
      -####@####                            @                                                         @@                   @@++++++@@        #@*+
      @####@####                            :#                                                           %@.                  %@*+++++@@. #@*++++
      @####@####                             @                                                              +@:                  .@@+++++@++++++@
      @####@####                             @                                                                 :@*                   @@++@++@@=  
      @####%####                             ++                                                                   .@@                   +@@      
      @#########                              @                                                                       @@                         
      @#######@@@@                            @                                                                          @@                      
      @####@@      @@                         @.                                                                       +@#%-                     
      @#@@            @@  @@@#@@=@=@.@@. #  @@                                                                      @@*++++@                     
      @@.                @@++=#=+@*=*=+=+@%                                                                      @@+++++++@@                     
      @++@@.                =@*=#=+==@@.                                                                     .@@++++++*@+                        
      @+++++#@=                .@@@@                                                                      :@@++++++@@.                           
        @@+++++*@@                                       .@@@@@@@@@@@@@@@@#=..                         @@*++++++@@.                              
           @@++++++@@                                 -@%===*++++++++++++++++++++++++++**#@@@@@@@@@@@@+++++++@@                                  
              @@++++++@@                       .   @@=======@%*+++++++++++++++++++++++++++++++++++++++++++@@                                     
                 @@++++++@@                  + .@%=======@@             .=#@@@@@@@@@@@@%**+++++++++++*#@+                                        
                    #@*+++++@@           *   @=+=====+@#                                          :-@.                                           
                       =@#+++++@@.        @====*+==@.                                                                                            
                          :@%+++++#@-  @====#==#===@                                                                                             
                             .@@+++++@========%%===@                                                                                             
                                .@@++@====*====@===@                                                                                             
                                    @@====%#===@===@                                                                                             
                                     @====@==*=%===@                                                                                             
                                     @====#===*%===@                                                                                             
