                                                                                           .@#                                                 @@
                                                                        :               .@*                                                      
                                                                      @=@             .@:                                                        
                                                                      *=@              @+*@@                                                     
                                                                   @=@=#@              @+++++@@                                                  
                                                                 .@==*==@              @*+++++++@@.                                              
                                                               .@=@=++=@@@               =@%+++++++%@:                                           
                                                          . .*+%=+@=@@     @@                @@+++++++*@#                                        
                                                  +=@-=@=*==+=%==@@           @@                %@*+++++++@@                                     
                                                  @========@==@@                 @@.               .@@+++++++@@                                  
                                                  @%=*==#==@@                       #@:                @@+++++++@@:                              
                                                  @==+==@@                             -@+                +@%++++++*@@                           
                                                  -==@@                                   .@@                 @@+++++++@@                        
                                                  .@                                         .@@                 @@*++++++@@.                    
                   :-                              @                                             @@                 .@@++++++%@:                 
                 @#@##@                            @                                                @@                  @@++++++*@%              
               .###@###*                           =*                                                  @@.                 *@%++++++@@           
               @###@###@                            @                                                     #@:                  @@++++++@@        
              -####@###%                            @                                                        -@=                  @@*+++++@@:    
              @####@###%                            %:                                                          .@@                  :@@+++++*@@ 
              @####@###%                             @                                                             .@@                   @@++++++
              @####@####                             @                                                                 @@                   %@#++
              @####@####                             @.                                                                   @@                    @
              @####%####                             .@                                                                      @@                  
              @########@@                             @                                                                         @@.              
              @####%@*    @@.                         @                                                                         @@@.             
              @#%@:          +@-  #.@@ @@@@@ #@     #@:                                                                     .@@+++*+             
              @*                .@@+*+==#**==@=@=@@.                                                                     -@%++++++@@             
              @+*@@                 @@=+=#=@==@@                                                                      @@*++++++@@                
              @+++++@@                 @@=+@#                                                                      @@+++++++@@                   
               %@*+++++@@                                         %@@@@@@@@@@+..                                @@++++++*@%                      
                  *@*+++++@@                                   @@===++++++++++++++++++++++*#%@@@@@@@@@@@@@@*-@@++++++#@-                         
                     -@#+++++@@.                            @@======%+++++++++++++++++++++++++++++++++++++++*+++++@@.                            
                        .@@+++++%@:                  -  -@=======#@+        =*@@@@@@@@@@@@%**+++++++++++++++*++@@                                
                           .@@+++++*@=            +  :@=======@@                                     :-#@@@@@@                                   
                              .@@+++++*@%         :@=======@@                                                                                    
                                  @@++++++@@   -@====#=+===@                                                                                     
                                     @@++++++@===%====++===@                                                                                     
                                        @@+++@=====@===*===@                                                                                     
                                           @@@====+=%==#===@                                                                                     
                                             @====#==+=%===@                                                                                     
                                             @====@===*@===@                                                                                     
                                             @====%+===@===@                                                                                     
                                             **===*==+=@===@                                                                                     
