                                                                                   @@*@#              *#++*@#                                    
                                                                                  @@==#*              .@++++++@@                                 
                                                                                @*=@=+=+               @@*+++++++@@                              
                                                                              @=*=#==@@ .@@               -@%+++++++@@:                          
                                                                  @@    #=+@===@==@%        @@                @@+++++++*@%                       
                                                                 @=#==+=#+==%==@#              @@                @@*+++++++@@                    
                                                                 @=@==%=%*==@*                    @@                .@@+++++++@@                 
                                                                 :=@=====@*                          %@.                @@+++++++@@.             
                                                                  +=#+@=                                +@-                =@%++++++*@#          
                                                                  %@-                                      :@*                 @@+++++++@@       
                                                                  @                                           .@@                 @@*++++++@@    
                                 @@##%                            @                                               @@                 .@@++++++@@:
                               @##@###+                            @                                                 @@                  @@++++++
                              .###@###%                            @                                                    @@                  +@%++
                              @###@####.                           @                                                       @@.                  @
                              ####%####.                           .%                                                         #@:                
                             @#########:                            @                                                            -@+             
                             @#########:                            @                                                               .@%          
                             @#########-                            =#                                                                 .@@       
                             *#########*                             @                                                                     @@    
                             +##########                             @                                                                        @@ 
                             :#####%%@- @@                           #:                                                                          
                             .###@@.       @@                        @@                                                                      .@@+
                              @@              @@:@=#==@====@*=@@@@@@                                                                      *@*++++
                             @#@-                -@%=%*@==#=+==@@                                                                      @@+++++++@
                             @+++*@*                .@@%==#*@+                                                                      @@+++++++@@  
                             @@++++++@@                 @@.                                                                     .@@++++++*@#     
                                @@++++++@@                                      @@=%++++++*#%@@@@@@@@@@@@@@#-:.              :@%++++++@@:        
                                   @@++++++@@                               .@@====@++++++++++++++++++++++++++++++++++++**#@%++++++@@            
                                      #@*+++++@@                      @  +@#======%@@@@@@@@@@#*+++++++++++++++++++++++++++++@+++@@               
                                         =@#+++++@@.             . *  @@=======@@                       :+@@@@@@@@@@@@%**+++@@@                  
                                            :@%+++++%@-          - #%=#=====@@                                                                   
                                               .@@+++++*@*      @@====@===@                                                                      
                                                   @@+++++*@@@*==@*===*===@                                                                      
                                                      @@++++@====%==@=+===@                                                                      
                                                         @@+%+===#===@+===@                                                                      
                                                            @*===#=====*==@                                                                      
                                                            .@=====*======@                                                                      
                                                             @======#=====@                                                                      
                                                             @============@                                                                      
                                                             @====+=======@                                                                      
                                                             @=====*====*   @@                                                                   
                                                             @=======%         @@                                                                
                                                             @====@               @@                                                             
