                                                                                      @#===%              :@+++++#@=                             
                                                                                    @+=#==+*               @@++++++++@@                          
                                                                                  @=@====@@ *@:               @@*+++++++@@                       
                                                                      *=    @+@*=#=+==@@       :@*               -@@+++++++@@.                   
                                                                     @=%==%+@===%==@@             .@@                @@+++++++#@+                
                                                                     @=@=%==+@==@@                    @@                #@#+++++++@@             
                                                                     ==#==#==@@                          @@                .@@+++++++@@          
                                                                      =+*=@@                                @@                 @@+++++++@@.      
                                                                      *@@                                      @@.                -@@++++++#@+   
                                                                      @                                           #@:                 @@++++++*@@
                                     @@#@.                            @                                              -@+                 %@*+++++
                                   ###@###:                           .@                                                .@@                 .@@++
                                  .###@###@                            @                                                    @@                  @
                                  @###@####                            @                                                       @@                
                                 .####@####.                           -*                                                         @@             
                                 @#########.                            @                                                            @@.         
                                 @#########.                            @                                                               #@.      
                                 @#########:                            #-                                                                 =@=   
                                 @#########=                             @                                                                    .@%
                                 %#########+                             @                                                                       
                                 -#####%#@@.@%                           @.                                                                      
                                 :###%@*      .@@                        -@                                                                      
                                 .@@.             @@ @+@=*@====#%=@@@@@@.                                                                     .@@
                                 @@@                 @@===*@===*=*=@@                                                                      =@#+++
                                 @+++@@.                *@+@##+=@@                                                                      @@*++++++
                                 @@+++++%@:                :@@=                                                                      @@+++++++@@ 
                                    @@+++++*@*                                      %@=#++**#%@@@@@@@@@@@@@@#+:..                 @@++++++*@%    
                                       @@+++++*@@                                @@====@++++++++++++++++++++++++++++++++++*#%@@@@++++++%@:       
                                          @@++++++@@                      @  .@@=======@@@@@@@%**+++++++++++++++++++++++++++++++%+++@@.          
                                             @@++++++@@              . #  @@=======@@:                  ..-#@@@@@@@@@@@@%**+++++@@@              
                                                @@*+++++@@          .: :@=@=====@@                                                               
                                                   #@*+++++@@       :@====@===@                                                                  
                                                      -@#+++++%@::@==%====#===@                                                                  
                                                         .@%++++@====@==*=*===@                                                                  
                                                            .@@+@====@===++===@                                                                  
                                                                @+===*=====@==@                                                                  
                                                                -%=====@======@                                                                  
                                                                 @======%=====@                                                                  
                                                                 @========*===@                                                                  
                                                                 @=========+==@                                                                  
                                                                 @===========. .@%                                                               
                                                                 @=======+         @@                                                            
                                                                 @====*               @@                                                         
                                                                 @=%                @@+@                                                         
