                                                                                           @@                                              @@=*=@
                                                                                        @@                                                    +  
                                                                     @@              @@                                                          
                                                                    #@@              @@@                                                         
                                                                 .@@==@              @+++@@                                                      
                                                                 +#==*@              @++++++%@-                                                  
                                                              .=====%=@              .@@+++++++*@@                                               
                                                            @**==*=@@. @@.               @@++++++++@@                                            
                                                :@    @=%==@*=%=@@.       +@-               =@@+++++++@@.                                        
                                                =+===@==%====@@              :@#                @@+++++++%@-                                     
                                                @=%=++=*=%@@                    .@@                @@*++++++*@%                                  
                                                @+=#@%=@@                           @@                .@@+++++++@@                               
                                                @@==@@                                 @@                 @@+++++++@@.                           
                                                =@@                                       @@.                +@%++++++%@-                        
                                                .@                                           @@.                 @@++++++*@@                     
               .@##@                             @                                              +@-                 @@*++++++@@                  
              @##%##@                            @                                                 :@#                 .@@++++++@@.              
             @###@###@                           :#                                                   .@@                  @@++++++%@-           
            .####@###@                            @                                                       @@                  *@%+++++*@@        
            @####@###@                            @                                                          @@                  .@@++++++@@     
            %####@###@                            #-                                                            @@                   @@*+++++@@@@
            %####@###@                             @                                                               @@.                  :@@++++@+
            @####@###@                             @                                                                  *@:                   @@+@*
            @####@###@                             @.                                                                    -@+                   . 
            @####@###@                             .@                                                                       .@%                  
            @####%#@@ -@*                           @                                                                          *@                
            @###@@       .@@         .   .          @                                                                       @@++@                
            @@%              @@ #*==#@=@=@@==%@*-@#                                                                      @@+++++%-               
            @@@                 @@=*=*=%=#+%=@@.                                                                     .@@++++++#@=                
            @+++@@                 @@==@==@@                                                                      -@%++++++@@.                   
            @@+++++@@.                -@@                                                                      @@*++++++@@                       
              .@@+++++#@-                                     :@%=+++++++*#%@@@@@@@@@@@@@@*-:               @@+++++++@@                          
                  @@+++++*@*                               @@=====+++++++++++++++++++++++++++++++++++++**%@++++++*@@                             
                     @@++++++@@                      =  @@=======@@@@@@@@@@%**++++++++++++++++++++++++++++#+++#@=                                
                        @@++++++@@               -.  @=======+@@                      .:*@@@@@@@@@@@@%**++#@@.                                   
                           @@++++++@@             @=======@@.                                                                                    
                              %@*+++++@@       @=========@                                                                                       
                                 *@*+++++@@.@====#=======@                                                                                       
                                    -@#++++@=============@                                                                                       
                                       .@%+@===%====*====@                                                                                       
                                          .@====#====%===@                                                                                       
                                           @====+#===+===@                                                                                       
                                           @====#=*==*===@                                                                                       
                                           @====@===@#===@                                                                                       
