                                                                                     @=%=+@              %*++++*@@                               
                                                                                   *%==@=#%              .@++++++++@@                            
                                                                                 .@=*=%==@#@*               @@*+++++++@@.                        
                                                                           @@@@@===@==@+     .@@               :@@+++++++@@:                     
                                                                    @=@@@++==+==#=+@=            @@                @@+++++++*@%                  
                                                                    @=+*==@==#=+@=                  @@                *@#+++++++@@               
                                                                    @==%====*@-                        @@                 @@+++++++@@            
                                                                    :=+==*@:                              @@.                @@*++++++@@:        
                                                                     =#@:                                    #@.                :@@++++++*@@     
                                                                     @                                          -@+                 @@+++++++@@  
                                    .@@@                             @                                             .@%                 %@#++++++@
                                  .@#@###                            #-                                                @@                  @@++++
                                  ###@###@                            @                                                   @@                  @@*
                                 @###@###%                            @                                                      @@                  
                                .####@####                            @                                                         @@.              
                                @####@####                             @                                                           @@.           
                                @####%####                             @                                                              =@=        
                                @#########                             @                                                                 :@#     
                                @#########.                            .@                                                                   .@@  
                                @#########.                             @                                                                       @
                                %#######%@@@                            @                                                                        
                                #####@@.     @@                         =#                                                                       
                                =#@@            @@  %@@*@@=@*# @@= -. @@                                                                      #@*
                                @@.                @@#==#=%@%==+=+=@@                                                                      @@++++
                                @++%@:                -@#=#==*=#@+                                                                      @@+++++++
                                @+++++*@+                .@@@@.                                                                     .@@++++++#@+ 
                                  @@+++++*@%                                        @@@@@@@@@@@@@@@%+-..                         -@%++++++@@.    
                                     @@++++++@@                                 .@@===@++++++++++++++++++++++++++*#%@@@@@@@@@@@@*++++++@@        
                                        @@++++++@@                       +   +@*======@#*++++++++++++++++++++++++++++++++++++++*++++@@           
                                           @@*+++++@@                  % *@@=======@@.           ..*@@@@@@@@@@@@%#*++++++++++++#*@@              
                                              *@*+++++@@.          :.  @*%======@@                                         .-+%=                 
                                                 -@#+++++%@:        @*===@#==@-                                                                  
                                                    .@@+++++#@+  @+=+=+==@===@                                                                   
                                                        @@+++++@====#===@%===@                                                                   
                                                           @@++@====@+===%===@                                                                   
                                                              @@====%+===#===@                                                                   
                                                               #+===*==@=*===@                                                                   
                                                               -#===+===@+===@                                                                   
                                                               .@===#====+===@                                                                   
                                                                @=====+======@                                                                   
                                                                @======#====#.@@                                                                 
                                                                @===@====@       @@                                                              
                                                                @=====@             @@                                                           
                                                                @==+                @@@                                                          
