                                                                                @=:             .@@                                              
                                                                              .#=+=              @++@@                                           
                                                                            .=*===*              @+++++@@.                                       
                                                                           @==*==+*              @%+++++++*@*                                    
                                                                     .   @=@====@@@@.               @@++++++++@@                                 
                                                             .    :@@@@@#=+=+@@      *@:               #@*+++++++@@                              
                                                           :==@@%=*==+=#==@@            -@+               .@@+++++++@@.                          
                                                            ===+==*=@==@@                  .@@                @@+++++++#@#                       
                                                            %+*==#==@@                         @@                =@%+++++++@@                    
                                                            @=+==@@                               @@                 @@+++++++@@                 
                                                            @=@@                                     @@                 %@*++++++@@.             
                                                            @.                                          @@                 .@@++++++#@*          
                            @@@.                            .@                                             @@.                 @@+++++++@@       
                          @#####@                            @                                                =@-                 +@%++++++@@    
                         @#######.                           @                                                   .@#                  @@++++++@@.
                        .########@                           .@                                                     .@@                  @@*+++++
                        @####%###@                            @                                                         @@                  .@@++
                        #####@###@                            @                                                            @@                   @
                        #####@###@                            =+                                                              @@.                
                        #####@###@                             @                                                                 @@.             
                        #####@###@                             @                                                                    +@-          
                        %####@###@                             %-                                                                      :@#       
                        @####@##@@@-                            @                                                                         .@@    
                        @####@#     .@%                         @                                                                        @@+@    
                        @@@:            @@  @@*@@#=%=@@@@ :@ @@:                                                                     .@@++++@    
                       :@@                 @@=#=@==@#=%=%=@@                                                                      -@#++++++@@    
                       .@++@@                 @@==@#@==@@                                                                      %@*++++++@@       
                       .@+++++@@.                +@%@*                                                                      @@+++++++@@          
                         .@@+++++@@.                                       #@@@@@@@@@@@@@@@@%+-.                         @@++++++*@@             
                            .@@+++++#@=                                 @@===@++++++++++++++++++++++++++++*#%@@@@@@@@@@@++++++%@-                
                                @@+++++*@%                           @@=======@@#*++++++++++++++++++++++++++++++++++++@++++@@.                   
                                   @@++++++@@              =  +  :@=======#@=             ..*@@@@@@@@@@@@%#*++++++++++@+@@                       
                                      @@++++++@@           =  :@=======@@.                                         ..-+                          
                                         @@++++++@@        :@====+===@                                                                           
                                            @@*+++++@@. -@====*======@                                                                           
                                               +@*+++++@=======+=====@                                                                           
                                                  -@#++@====@====+===@                                                                           
                                                     .@@=====*=======@                                                                           
                                                       @======#======@                                                                           
                                                       @=======#=====@                                                                           
                                                       @=========#===@                                                                           
                                                       @====*=+======@                                                                           
                                                       @====#=======.=@=                                                                         
                                                       @===+@====:      .@@                                                                      
