                                                                                        @@                               .@@=+=+==@=@=@@=@@:@:@# 
                                                                                     @@                                      @@==#=#@@@=*=@@.    
                                                                                  @@                                            @@*=@==@@        
                                                                               @@                                                  @@%           
                                                           %-              .@@                                                                   
                                                          @==             .@@                                                                    
                                                         *==#              @++@@                                                                 
                                                       =+===@              @+++++@@.                                                             
                                                     @=====#@              @@+++++++#@#                                                          
                                                   @*#==+=@@@@.               @@++++++++@@                                                       
                                       .    .@@@@@@===#@@      #@:               %@*+++++++@@                                                    
                                     .==@@@=#==#=+==@@            -@=               .@@+++++++@@.                                                
                                      ===*==+=%==@@                  .@%                @@+++++++*@*                                             
                                      @#+==@==@@                         @@                =@@+++++++@@                                          
                                      @=#==@@                               @@                 @@+++++++@@                                       
                                      @=@@                                     @@                 @@*++++++@@.                                   
                                      @:                                          @@.                .@@++++++#@#                                
      #@@.                             @                                             %@.                 @@+++++++@@                             
    @#####@                            @                                                =@=                 +@%++++++@@                          
   @#######:                           @.                                                  .@@                  @@++++++@@.                    = 
   ####%###@                           .@                                                     .@@                  @@*+++++*@*              @@   
  @####@###@                            @                                                         @@                  .@@++++++@@        @@+++@* 
  %####@###@                            @                                                            @@                   @@++++++@@  @@+++++++*@
  #####@###@                            .@                                                              @@.                  +@%+++++@+++++*@@+++
  %####@###@                             @                                                                 @@.                   @@++@++@@   @+++
  %####@###@                             @                                                                    +@-                   @@:      @+++
  @####@###@                             ++                                                                      :@*                         @+++
  @####@##@@@-                            @                                                                         .@@                      @+++
  @####@@     .@@                         @                                                                        @@+@                      @+++
  @%@+            @@  @%@@%@=@=@%@@ .@ +@+                                                                      @@++++@                      @+++
 .@@                 @@=#=@==@+=@=@=@@.                                                                     .@@++++++%@                      @+++
 .@++@@                 @@==@@@==@@                                                                      +@#++++++@@.                        @+++
  @+++++@@.                *@@@@                                                                      @@+++++++@@                            @+++
   .@@+++++%@.                                       =@@@@@@@@@@@@@@@@%-:.                         @@+++++++@@                               @+++
       @@+++++#@+                                 @@===++++++++++++++++++++++++++++**#@@@@@@@@@@@@++++++*@#                                  .@@+
          @@+++++*@@                           @@=======@%**++++++++++++++++++++++++++++++++++++@++++@@:                                         
             @@++++++@@              :  :. .@=======+@#             .-*@@@@@@@@@@@@%**++++++++++@+@@                                             
                @@++++++@@           #  .@=======@@.                                         ..=%                                                
                   @@++++++@@        .@========@                                                                                                 
                      %@*+++++@@  .@====%======@                                                                                                 
                         +@*+++++@=============@                                                                                                 
                            -@#++@====@====#===@                                                                                                 
                               .@@=====%=======@                                                                                                 
                                 @======*======@                                                                                                 
