                                                                                       @=%=%=:              @+++++++@@                           
                                                                                     @==#=@=#*               @@++++++++@@                        
                                                                                   @+==#=%@.  .@@               -@@+++++++@@.                    
                                                                      :@@   %@#==#=%++@@.         @@                @@+++++++*@*                 
                                                                      :=@==%==@====@@.               @@                @@*+++++++@@              
                                                                      .=@==*=+==@@.                     @@                .@@+++++++@@           
                                                                       #==@=#@@                            @@.                @@+++++++@@.       
                                                                       @==@@.                                 %@:                =@%++++++*@#    
                                                                       @@                                        -@+                 @@+++++++@@ 
                                                                       %:                                           .@%                 @@*++++++
                                      @###@                             @                                              .@@                 .@@+++
                                    +######@                            @                                                  @@                  @@
                                    %#######:                           @                                                     @@                 
                                   @########@                            @                                                       @@.             
                                   %########@                            @                                                          #@:          
                                  .#####%###@                            @                                                             -@=       
                                  .#####@###@                            :%                                                               .@@    
                                  .#####@###@                             @                                                                   @@ 
                                   #####@###@                             @                                                                      
                                   #####@###@                             ++                                                                     
                                   %####@@@   @@                           @                                                                     
                                   @##@@         @@      @  @. @.         @@                                                                     
                                  .@@               %@##=@%=*===@==@@**@%                                                                      @@
                                  *#%@:                -@#=@=%++=#=%@:                                                                     .@@+++
                                  -%+++*@*                .@@=+=@@                                                                      .@@++++++
                                   @@+++++*@@                 @                         #-:.                                         *@*++++++@@ 
                                      @@++++++@@                                    :@@=@++++++++++++**#@@@@@@@@@@@@@@@*=..       @@+++++++@@    
                                         @@*+++++@@                              @@+====%++++++++++++++++++++++++++++++++++++++++@++++++@@       
                                            %@*+++++@@                     @  @@=======@@:+@@@@@@@@@@@@%#*+++++++++++++++++++++++@++*@*          
                                               +@*+++++@@.            *-.  @========@@                            .:#@@@@@@@@@@@@@@.             
                                                  :@%+++++%@:         - @=======@@:                                                              
                                                     .@@+++++*@+     @====+====+#                                                                
                                                        .@@+++++*@@====#====@==+#                                                                
                                                            @@++++@============+#                                                                
                                                               @@+@=======+====+#                                                                
                                                                  @===*====%===+*                                                                
                                                                  @====%====@==+*                                                                
                                                                  @=====*======+*                                                                
                                                                  @=======@====++                                                                
                                                                  @====@===@===+@                                                                
                                                                  @====*%====%    @@                                                             
                                                                  @====%===          @@                                                          
                                                                  @=====                @@                                                       
                                                                  *+.               .@@++@                                                       
