                                                                                    @====@              @++++@@.                                 
                                                                                   @=====@              @+++++++#@+                              
                                                                                 @=+==%=@@.               @@++++++++@@                           
                                                                              .%#@=+=@@    *@:               @@*+++++++@@                        
                                                                   @==  @@@==@===*@@          :@+               .@@+++++++@@.                    
                                                                   #===%==*=*==@@                .@@                @@+++++++#@*                 
                                                                   @*====%==@@                       @@                +@#+++++++@@              
                                                                   @==@==@@                             @@                .@@+++++++@@           
                                                                   @==@@                                   @@                 @@*++++++@@.       
                                                                   *@                                         @@.                :@@++++++#@+    
                                                                    @                                            %@.                 @@+++++++@@ 
                                  @####@                            @                                               =@=                 *@#++++++
                                .###%###                            @                                                  .@#                 .@@+++
                                @###@###@                           .@                                                    .@@                  @@
                               #####@###@                            @                                                        @@                 
                               @####@###@                            @                                                           @@              
                               #####@###@                            :%                                                             @@.          
                               %####@###@                             @                                                                @@.       
                               @####@###@                             @                                                                   +@=    
                               @####@###@                             *=                                                                     :@# 
                               @####@###@-                             @                                                                        .
                               @####@@@   .@@                          @                                                                         
                               @##@@          @@   : @- @@.@@ .-     .@@                                                                      @@+
                               @=                @@=@=#==+@=#=*+*=#@-                                                                      @@++++
                               @+@@                 @@+=*=@==%=@@                                                                      .@@++++++@
                               @++++@@.                +@+#=@@                                                                      *@*++++++@@  
                               .@@+++++@@:                .                        .@@@@%*=..                                    @@+++++++@@     
                                   @@+++++#@+                                   #@*=+++++++++++++++++++#%@@@@@@@@@@@@@@@+:.   @@++++++*@@        
                                      @@+++++*@@                             @@======*+++++++++++++++++++++++++++++++++++++++#+++++*@+           
                                         @@++++++@@                   .-  @@=======@@   .:*@@@@@@@@@@@@%#++++++++++++++++++++#++@@.              
                                            @@++++++@@             %   @=======%@=                                .-*@@@@@@@@@@                  
                                               @@++++++@@           @=======@@                                                                   
                                                  %@*+++++@@.    @====%=====@                                                                    
                                                     =@*+++++%@=========*===@                                                                    
                                                        :@%+++@=====+=======@                                                                    
                                                           .@@@======*======@                                                                    
                                                              @========#====@                                                                    
                                                              @====%====*===@                                                                    
                                                              @====#@===*===@                                                                    
                                                              @====@==@=#===@                                                                    
                                                              @====@===%%===@=                                                                   
                                                              +*===*+===@-    .@@                                                                
                                                              :%===+==.          .@@                                                             
                                                               @===.               .@@                                                           
