                                                                              @=.             @@                                                 
                                                                             -%=.              @@@:                                              
                                                                           @@=+=.              @+++*@@                                           
                                                                          @=@=#=:              @+++++++@@                                        
                                                                        @==*=%=@@               @@*+++++++@@.                                    
                                                                      %*==*=@@.   @@               :@@+++++++%@-                                 
                                                         -@@   @@%==%=#=+@@.         @@                @@+++++++*@%                              
                                                         :+@==@==%====@@                @@                #@#+++++++@@                           
                                                         .=%==+=*==@@                      @@                .@@+++++++@@                        
                                                          #==@=%@@                            @@.                @@*++++++@@:                    
                                                          @==@@                                  +@-                -@@++++++*@@                 
                                                          @@                                        :@#                 @@+++++++@@              
                                                          #:                                           .@@                 %@#++++++@@.          
                         @###%                             @                                               @@                 .@@++++++%@:       
                       *######@                            @                                                  @@                  @@++++++*@%    
                       %#######:                           @                                                     @@                  -@@++++++@@ 
                      @########@                            @                                                       @@.                  @@++++++
                      %########@                            @                                                          *@-                  @@*++
                     .#####%###@                            @                                                             :@*                  .@
                     .#####@###@                            :%                                                               .@@                 
                     .#####@###@                             @                                                                   @@              
                      #####@###@                             @                                                                      @@           
                      #####@###@                             =+                                                                        @@        
                      %####@@@   @@                           @                                                                         %@@      
                      @##@@         @@.     @  @. @.        .@@                                                                      @@+++@      
                     .@@               #@%*=@%=%===@==@@+*@*                                                                      @@++++++@      
                     +##@=                :@@=%=@++=*=@@.                                                                     .@@++++++#@+       
                     -%+++*@#                 @@=+=@@                                                                      -@%++++++@@.          
                      @@++++++@@                 @                         @*=..                                        %@*++++++@@              
                         @@++++++@@                                    -@%=@++++++++++++++*#@@@@@@@@@@@@@@@*:.       @@+++++++@@                 
                            @@*+++++@@                              @@=====#++++++++++++++++++++++++++++++++++++++++@+++++*@@                    
                               *@*+++++@@                     #  @@=======@@.=#@@@@@@@@@@@@%*+++++++++++++++++++++++@++#@=                       
                                  -@#+++++@@.            *=   @=======+@#                            ..=#@@@@@@@@@@@@@.                          
                                     .@%+++++#@-         - @=======@@.                                                                           
                                         @@+++++*@#     @====+====+#                                                                             
                                            @@++++++@@====*====%==+#                                                                             
                                               @@++++@============+#                                                                             
                                                  @@+@============+#                                                                             
                                                     @===+====@===+*                                                                             
                                                     @====%====%==+*                                                                             
                                                     @=====#======++                                                                             
                                                     @=======@====++                                                                             
                                                     @====%===@===+@                                                                             
                                                     @====*#====*    @@                                                                          
