                                                                            :                @@                                                  
                                                                           *#              @@                                                    
                                                                          @=*              **+@@                                                 
                                                                       @====+              .@++++@@.                                             
                                                                      @==%+@@               @+++++++#@+                                          
                                                                    *++==#=@@@.               @@+++++++*@@                                       
                                                             .. .+@*==+=@@.    @@.               @@*+++++++@@                                    
                                                      @=%:.@*@==@====@@.          =@=               .@@+++++++@@.                                
                                                      @=#=@==#=+==@@                 .@%                @@+++++++#@=                             
                                                      -#==+=#==@@                       .@@                *@#++++++*@@                          
                                                      .==@==@@                              @@                .@@+++++++@@                       
                                                       #=@@                                    @@                 @@*++++++@@.                   
                                                       @                                          @@.                :@@++++++#@+                
                       .-.                             @                                             %@.                 @@+++++++@@             
                     @#@###                            :@                                               +@-                 #@#++++++@@          
                    @##@###@                            @                                                  :@#                 .@@++++++@@.      
                   @###%####                            @                                                     .@@                  @@*+++++#@=   
                   %###%####-                           +=                                                        @@                  :@@+++++*@@
                  -#########-                            @                                                           @@                   @@+++++
                  @#########-                            @                                                              @@                   #@#+
                  @#########=                            @:                                                                @@.                  .
                  ###########                             @                                                                   *@:                
                  -#####%###@                             @                                                                      -@+             
                  :#####%##@@:                            @                                                                         .@%          
                  .#####@@    :@@                         .@                                                                        @@*@         
                   ##@@           @@   @:@=:%@@* =@@    .@@                                                                      @@++++@         
                  @@                 @@+@=#=++=#=+=++#@=                                                                      @@++++++*@         
                  @++@@                 @@==#=====@@.                                                                     .@@++++++%@-           
                  @+++++@@                 #@+=@@                                                                      +@#++++++@@.              
                   .@@+++++@@.                                        .@@@@@@@@@%*:..                               @@*++++++@@                  
                       @@+++++#@-                                  +@*==@+++++++++++++++++++++*#%@@@@@@@@@@@@@@%=@@+++++++@@                     
                          @@+++++*@*                       *    @@======@++++++++++++++++++++++++++++++++++++++++@++++*@@                        
                             @@++++++@@               =  .=# @%=======@@      ..:+%@@@@@@@@@@@@#*++++++++++++++++@+%@-                           
                                @@++++++@@            %   @*======*@+                                    .:*@@@@@@.                              
                                   @@++++++@@         #@===*===@@.                                                                               
                                      %@*+++++@@.   @=@==%=+===@                                                                                 
                                         *@*+++++@====%====#===@                                                                                 
                                            -@#++%====*+====%==@                                                                                 
                                               .@@%=====#======@                                                                                 
                                                 .@=======#====@                                                                                 
                                                  @===#====*===@                                                                                 
                                                  @====@=======@                                                                                 
                                                  @======@=====@                                                                                 
                                                  @===*===%====%@-                                                                               
