                                                                                   @==               @+*@%                                       
                                                                                -=====.              @+++++@@                                    
                                                                               @=====@.              @++++++++@@                                 
                                                                             @#*==*+@@@@               *@%+++++++@@.                             
                                                                      .@=@@@%=%==@@      @@                @@+++++++*@*                          
                                                               @==@@@=@==@====@@            @@                @@*+++++++@@                       
                                                               .=+=@==+=*==@@                  @@.               :@@+++++++@@                    
                                                                +====@==@@                        @@.                @@+++++++@@.                
                                                                %=%==@@                              +@-                #@#++++++*@#             
                                                                @=@@                                    :@#                .@@+++++++@@          
                                                                @                                          .@@                 @@*++++++@@       
                                :@@                             =*                                             @@                 :@@++++++@@.   
                              @#####@                            @                                                @@                  @@++++++*@*
                             @######%                            @                                                   @@                  @@#+++++
                            :########-                           #:                                                     @@.                 .@@++
                            @########@                            @                                                        +@-                  @
                            #########@                            @                                                           :@*                
                           :#####%###@                            @.                                                             .@@             
                           .#####@###@                             @                                                                 @@          
                            #####@###@                             @                                                                    @@       
                            #####@###@                             @                                                                       @@    
                            #####@##@@@                            :@                                                                         @@.
                            %####@@     @@.                         @                                                                        @@+@
                            %#@#           #@:  @.+@ =@@=+%@@  * :@#                                                                      @@++++@
                           *@=                :@#=*+==#+%=#=##@@.                                                                     .@@++++++#@
                           +#+*@%                 @@=+==#==@@                                                                      -@%++++++@@.  
                           -#+++++@@                 @@+@@                                                                      @@*++++++@@      
                             @@++++++@@                                        :@@@@@@@@@@@@@%+:..                           @@+++++++@@         
                                %@*+++++@@                                  @@===@+++++++++++++++++++++++++*#%@@@@@@@@@@@@@@++++++*@@            
                                   +@*+++++@@                       .    @@======+*+++++++++++++++++++++++++++++++++++++++@++++#@=               
                                      -@#+++++@@.              @  ..  @+=======@@          ..*%@@@@@@@@@@@@#*+++++++++++++@+@@.                  
                                         .@@+++++#@-           @   @=======@@:                                       .-+@@@                      
                                            .@@+++++*@*        -@=======+@                                                                       
                                                @@++++++@@  .@====@=====+#                                                                       
                                                   @@+++++*@========+===+*                                                                       
                                                      @@+++@====#====@==+*                                                                       
                                                         @@@=====@======++                                                                       
                                                           @============*+                                                                       
                                                           @============*=                                                                       
                                                           @====#====%==*=                                                                       
                                                           @======%=====*-                                                                       
                                                           @=======#====+@@                                                                      
                                                           @====*====:      @@                                                                   
                                                           @====#=.            @@.                                                               
