                                                                                       :@*                              @@=@=*++@==%=@+@@@ . #@: 
                                                                                    :@+                                    @@==#=@=%%@=++=@@     
                                                                                 -@=                                          %@===@+==@@        
                                                                              -@-                                                =@@@:           
                                                                           =@-                                                                   
                                                         @=#             @@                                                                      
                                                        .==#              @+@@:                                                                  
                                                      @=@==@              @++++*@@                                                               
                                                    =@==#==@              @++++++++@@                                                            
                                                  .@=@=+@=@@%               @@*+++++++@@.                                                        
                                            .  .@=**#+=@@    .@@               :@@+++++++%@:                                                     
                                    .==%.+@======@==@@           @@                @@+++++++*@#                                                  
                                     #=====+==%==@%                 @@                *@#+++++++@@                                               
                                     @==%==*==@%                       @@                 @@+++++++@@                                            
                                     @=====@%                             @@.                @@*++++++@@:                                        
                                     @==@*                                   *@:                :@@++++++*@@                                     
                                     @+                                         :@*                 @@+++++++@@                                  
      ::                              @                                            .@@                 %@#++++++@@.                              
   .@####@                            @                                                @@                  @@++++++%@:                           
  ####%###                            @                                                   @@                  @@*+++++*@%                      # 
  @###%###@                           .@                                                     @@                  :@@++++++@@               .@    
 @####@###@                            @                                                        @@.                  @@++++++@@         .@@++@.  
 @####@###@                            @                                                           #@:                  @@#+++++@@:   @@++++++@* 
 #####@###@                            -#                                                             -@+                  .@@+++++*@++++++#@++*@
 %####@###@                             @                                                                .@@                   @@*++@++*@@  @++++
 %####@###@                             @                                                                    @@                   -@@@.     @++++
 @####@###@                             +=                                                                      @@                          @++++
 @####@###@@                             @                                                                         @@                       @++++
 @####@@-    @@                          @                                                                        .@@@                      @++++
 @#@@.          @@.  @ @@ @@@@@ @@     @@.                                                                     :@@+++@.                     @++++
 @.                %@++=@==@%#==@=@=@@                                                                      *@*++++++@-                     @++++
 @+%@-                :@%=%=@=@==@@                                                                      @@+++++++@@                        @++++
 @++++*@*                .@@%#@=                                                                      @@++++++*@@                           @++++
  @@+++++*@@                                         @@@@@@@@@#+-                                  @@++++++#@+                              @++++
     @@++++++@@                                   @@==++++++++++++++++++++++*#%@@@@@@@@@@@@@@%=-@%++++++@@.                                 @@+++
        @@++++++@@                            .@@======*+++++++++++++++++++++++++++++++++++++++@+++++@@                                        @@
           %@*+++++@@.              .   *  #@=======@@:      ..*@@@@@@@@@@@@%#+++++++++++++++++@++@@                                             
              =@#+++++@@.           .-  +@=======@@                                     -*@@@@@@@                                                
                 :@%+++++%@-         +@=======@@                                                                                                 
                    .@@+++++*@*   #%====*=====@                                                                                                  
                        @@+++++*@===@====*====@                                                                                                  
                           @@+++@=====@=======@                                                                                                  
                              @@@======#======@                                                                                                  
                                @=======*=====@                                                                                                  
