                                                                                          #@.                                          -@*==@==*@
                                                                                       %@.                                                .@@@.  
                                                                    .               @@.                                                          
                                                                  @=#             *@:                                                            
                                                                 :==%              @+*@%                                                         
                                                               *=%==@              @+++++@@                                                      
                                                             %@==@=+@              @++++++++@@                                                   
                                                           .@=*=#%=@@@               +@%+++++++@@.                                               
                                                     -.:-@===@#=@+     @@                @@+++++++*@#                                            
                                             .==@+@@===+==%=+@+           @@                @@*+++++++@@                                         
                                              +==*==%==+=+@=                 @@.               .@@+++++++@@                                      
                                              @+=@====*@-                       %@:                @@+++++++@@:                                  
                                              @=+==*@:                             =@=                *@%++++++*@#                               
                                              @=#@:                                   .@@                 @@+++++++@@                            
                                              #:                                          @@                 @@*++++++@@                         
               %%                              @                                             @@                 :@@++++++@@.                     
            -%####@                            @                                                @@                  @@++++++*@%                  
           ####%###.                           @.                                                  @@                  #@#++++++@@               
           %###%###@                            @                                                     %@.                 .@@++++++@@            
          @####@###@                            @                                                        =@-                  @@*+++++@@:        
          @####@###@                            @                                                           :@*                  :@@+++++*@#  :@#
          #####@###@                            :@                                                             .@@                   @@++++++@+++
          %####@###@                             @                                                                 @@                   %@#++@++#
          @####@###@                             @                                                                    @@                   .@@@  
          @####@###@                             =+                                                                      @@                      
          @####@##%@@                             @                                                                         @@.                  
          @####@@.    @@.                         @                                                                        .@@@                  
          @#@@           *@:  @.@@ @@@%@ @@  .  @@                                                                      +@#+++@.                 
          @=                :@%=+@==#@@==@=*=@@                                                                      @@*++++++@-                 
          @+*@%                .@@=+=@=#=*@*                                                                      @@+++++++@@                    
          @+++++@@                 @@%@@.                                                                      @@++++++*@+                       
           @@++++++@@                                         @@@@@@@@@@@#+-                               :@@++++++@@.                          
              #@*+++++@@                                  .@@==++++++++++++++++++++++++*#%@@@@@@@@@@@@@@@@*++++++@@.                             
                 =@*+++++@@                            =@#======++++++++++++++++++++++++++++++++++++++++%+++++@@                                 
                    :@%+++++@@.              .   @  @@=======@@.        .-%@@@@@@@@@@@@%*+++++++++++++++%++@@                                    
                       .@@+++++#@-           :.  @*=======@@                                      .=#@@@@+                                       
                           @@+++++*@#         @*=======@-                                                                                        
                              @@++++++@@   @+==========@                                                                                         
                                 @@++++++@===#====@====@                                                                                         
                                    @@+++@=====+===+===@                                                                                         
                                       @@@=============@                                                                                         
                                         @=======@=====@                                                                                         
                                         @====+===@+===@                                                                                         
                                         @====#====*===@                                                                                         
