                                                                                       %@.                            @@@*@*=@@===@=% %#     @@. 
                                                                                    @@                                   *@==#=%==@%=#*===@@     
                                                                                 @@                                         -@*==*@=+*#@=        
                                                                              @@                                               .@%@@@.           
                                                                           @@                                                                    
                                                        @=-             @@                                                                       
                                                       .*==              @#@*                                                                    
                                                     @@=*=@              @++++@@                                                                 
                                                    @+%=%=@              @+++++++@@                                                             @
                                                  @==+=@=*@               #@#+++++++@@.                                                          
                                                @===@=*@:   @@               .@@+++++++#@+                                                       
                                    @+   *@*==#=+*%#@:         @@                @@++++++++@@                                                    
                                    =+==%==@====%@.               @@.               -@@+++++++@@                                                 
                                    *@==#====%@.                     @@.                @@+++++++@@.                                             
                                    @+=#=%@@.                           =@=                @@*++++++#@*                                          
                                    @==@@                                  :@#                .@@+++++++@@                                       
                                    @@                                        .@@                 @@+++++++@@                                    
                                    :%                                            @@                 =@@++++++@@.                                
   @####.                            @                                               @@                  @@++++++#@+                             
 .######@                            @                                                  @@                  @@*++++++@@                        @ 
 @########                           ++                                                    %@.                 .@@++++++@@                 =     
@####%###@                            @                                                       +@:                  @@++++++@@.          #@*+@    
@####@###@                            @                                                          :@*                  +@%+++++#@*    *@*+++++@   
#####@###@                            @.                                                             @@                   @@++++++@@*+++++++++@. 
#####@###@                             @                                                                @@                   @@*+++@+++*@@ @+++@@
%####@###@                             @                                                                   @@                   .@@@@@     @+++++
%####@###@                             @.                                                                     @@                           @+++++
@####@###@                             .@                                                                        @@.                       @+++++
@####@@@.  @@.                          @                                                                         -@@                      @+++++
@##@@         #@:     @  @: @+         @@                                                                      @@*++@                      @+++++
@@               -@#==@#=@=*=@==@@#=@@                                                                      @@++++++@.                     @+++++
@*@%                .@@+#=%%*=%=%@=                                                                      @@++++++*@%                       @+++++
@++++@@                 @@=%=@@.                                                                     .@@++++++#@-                          @+++++
@@++++++@@                 @                         %*=.                                         =@#++++++@@.                             @+++++
   #@*+++++@@                                    .@@=%++++++++++++++*#%@@@@@@@@@@@@@@*:..      @@*++++++@@                                 @*++++
      +@*+++++@@                              *@*=====++++++++++++++++++++++++++++++++++++++++@++++++@@                                      +@*+
         :@%+++++@@.                    @  @@=======@@.-%@@@@@@@@@@@@%*+++++++++++++++++++++++@++*@@                                            :
            .@@+++++#@-            ...  @+=======@@                             .=#@@@@@@@@@@@@@-                                                
                @@+++++*@*           @=======%@-                                                                                                 
                   @@++++++@@     @==========@                                                                                                   
                      @@++++++@@====%====@===@                                                                                                  @
                         @@++++@======+======@                                                                                                  @
                            @@+@=======*=====@                                                                                                  @
                               @===*====%====@                                                                                                  @
