                                                                                       *@.                             @@=@+=*@#@===@ @@@    @@. 
                                                                                    #@.                                   @@====+%===%====@@     
                                                                                 %@.                                         @@==+==+=*@%        
                                                                              @@.                                               %@=@@.           
                                                                           @@.                                                                   
                                                         +@             .@.                                                                      
                                                        @=@              @+@@.                                                                   
                                                     @+#@#@              @++++#@=                                                                
                                                    @@==@=@              =#+++++++@@                                                            .
                                                  .=***#==@-               @@++++++++@@                                                          
                                                @===@=+@+   :@#               *@%+++++++@@                                                       
                                    @=@  @@===+==%=+@=         .@@                @@+++++++#@=                                                   
                                    @+==*==%==*=*@-                @@                @@*++++++*@@                                                
                                    @%==@====*@-                      @@                :@@+++++++@@                                             
                                    %*=+==*@:                            @@                 @@+++++++@@.                                         
                                    .==#@.                                  @@.                *@#++++++#@=                                      
                                     @.                                        *@:                .@@++++++*@@                                   
                                     @                                            -@+                 @@*++++++@@                                
   @#@##@                            @                                               .@@                 :@@++++++@@.                            
  @##@####                           .@                                                 .@@                  @@++++++%@=                       @ 
 @###@###@                            @                                                     @@                  #@#+++++*@@                =     
 ####@####                            @                                                        @@                  .@@++++++@@          =@*+@:   
@####@####                            -*                                                          @@.                  @@*+++++@@.   -@#+++++%@  
@####@####                             @                                                             #@:                  -@@+++++#@#++++++#+++@ 
@####%####                             @                                                                -@+                   @@+++@+++*@@ @++++@
@#########                             *-                                                                  .@@                   #@@@@     @+++++
@#########.                             @                                                                     .@@                          @+++++
@########%@                             @                                                                         @@                       @+++++
@#####@@.   @@                          @.                                                                        .@@*                     @+++++
%##@@          @@     @# @@.%@  .      @@                                                                      +@#+++@                     @+++++
@@                @@@%*%==*==#+*@%%=@@                                                                      @@+++++++@                     @+++++
@+@@.                *@*=@=%*=@=*@*                                                                      @@+++++++@@                       @+++++
@++++%@:                .@@==@@.                                                                      @@++++++*@#                          @+++++
 @@+++++*@*                                          @@@@%=..                                     :@%++++++@@:                             @+++++
    @@++++++@@                                   .@@==*+++++++++++++++**#@@@@@@@@@@@@@@@+-..   #@*++++++@@                                 @@++++
       @@++++++@@                             -@%=====@++++++++++++++++++++++++++++++++++++++++*+++++@@                                       @@+
          @@++++++@@                .   @= @@=======@@.  :=#@@@@@@@@@@@@#*+++++++++++++++++++++*+*@@                                             
             @@*+++++@@             ..  @%=======@@                               .:+@@@@@@@@@@@*                                                
                +@*+++++@@.         .@+==#===#@+                                                                                                 
                   -@#+++++%@:    @+====+%===@                                                                                                   
                      .@@+++++*@+===@====@===@                                                                                                  @
                         .@@+++@====#=*==@===@                                                                                                  @
                             @@@====@==*=@===@                                                                                                  @
                               @===*%===##===@                                                                                                  @
