                                                                                  ==:              @@@.                                          
                                                                               @@=%=+              @+++#@*                                       
                                                                              *#@=@=*              @+++++++@@                                    
                                                                            @==%=#==%               @@++++++++@@                                 
                                                                          @===@=+@+  .@@               =@%+++++++@@.                             
                                                             .@%   -@===+=#@*+@=        .@@                @@+++++++*@*                          
                                                             .=#==*==#==*=+@=               @@                @@*+++++++@@                       
                                                              +#==@====@@-                     @@                .@@+++++++@@                    
                                                              @*=#=%#@:                           @@                 @@+++++++@@.                
                                                              @==#@:                                 #@.                +@%++++++#@*             
                                                              @@.                                       -@=                 @@+++++++@@          
                                                              ++                                           .@@                 @@*++++++@@       
                             @###@.                            @                                               @@                 .@@++++++@@.   
                           .######@                            @                                                  @@                  @@++++++#@*
                           @#######=                           #:                                                    @@                  *@#+++++
                          @####%###@                            @                                                       @@                   @@++
                          @####%###@                            @                                                          @@.                  @
                          #####@###@                            @                                                             +@-                
                          #####@###@                             @                                                               :@*             
                          #####@###@                             @                                                                  .@@          
                          %####@###@                             @                                                                      @@       
                          %####@###@                             :%                                                                        @@    
                          @####@@@.  @@                           @                                                                         .@@  
                          @##@@         @@      @  @  -:         @@                                                                      =@#++@  
                          @@               @@=%=#%=#=+=@==%@@=@@                                                                      @@*+++++@  
                         :@%@:                =@#+@=%*%=@=+@#                                                                      @@+++++++@@   
                         .@+++#@=                .@@=#=@@.                                                                      @@++++++*@*      
                          @@+++++*@%                 @                         =:.                                          :@@++++++%@:         
                             @@++++++@@                                     @@=@++++++++++++*#%@@@@@@@@@@@@@@#-..        #@*++++++@@.            
                                @@++++++@@                              -@%====+++++++++++++++++++++++++++++++++++++++++@++++++@@                
                                   @@*+++++@@                     #  @@=======@@*@@@@@@@@@@@@%#*++++++++++++++++++++++++@+++@@                   
                                      +@*+++++@@.            :.-  @#=======@@                           .-+@@@@@@@@@@@@%@@*                      
                                         -@#+++++@@:         . @+======*@*                                                                       
                                            .@@+++++#@=     @+====*====@                                                                         
                                               .@@+++++*@@+===@====#===@                                                                         
                                                   @@++++@======#======@                                                                         
                                                      @@+@=======%=====@                                                                         
                                                         @===@====+====@                                                                         
                                                         @====+====#===@                                                                         
                                                         @=============@                                                                         
                                                         @====+==+=====@                                                                         
                                                         @====%===*====@                                                                         
                                                         @====%@===+@    @@                                                                      
                                                         @====@==@          @@                                                                   
