                                                                                         .@@                                        @@==*=#=#+=@@
                                                                                      .@@                                              @@=*=@@   
                                                                                   .@@                                                    .      
                                                                 +@             .@#                                                              
                                                                *%@              @@@.                                                            
                                                             =@%+=@              @+++%@=                                                         
                                                             %@===@              @++++++*@@                                                      
                                                          .==#==+=@               @@++++++++@@                                                   
                                                        @=@====@@  :@@               #@#+++++++@@.                                               
                                            @@    @=#==#=+@=@@        .@@               .@@+++++++#@-                                            
                                            =%===*==+=#==@@               @@                @@*++++++*@@                                         
                                            @===%==@=*@@                     @@                -@@+++++++@@                                      
                                            @#=+#@=@@                           @@                 @@+++++++@@.                                  
                                            @+==@@                                 @@.                @@#++++++%@=                               
                                            -@@                                       +@:                .@@++++++*@@                            
                                             @                                           :@*                 @@+++++++@@                         
           +%##@.                            @                                              .@@                 -@@++++++@@.                     
          @##%##@                            @                                                  @@                  @@++++++%@-                  
         @###@###@                           .%                                                    @@                  @@*+++++*@@               
        :####@###@                            @                                                       @@                  .@@++++++@@            
        @####@###@                            @                                                          @@.                  @@++++++@@.     @@+
        %####@###@                            ++                                                            #@:                  =@%+++++%@@@++++
        %####@###@                             @                                                               -@+                   @@++++@++++@
        @####@###@                             @                                                                  .@@                   @@*@#@@  
        @####@###@                             %:                                                                    .@@                         
        @####@###%                              @                                                                        @@                      
        @####%#@@  @@                           @                                                                          @@                    
        @##%@*        @@      -  *   :         -@                                                                       @@++@                    
        @@:              @@.@=*==@=@=%@==@@=@@.                                                                     .@@+++++#-                   
        @@@.                *@+%#=*%+=*==@@                                                                      =@#++++++@@.                    
        @+++%@:                .@@=#==@@                                                                      @@*++++++@@                        
        @@+++++*@*                 @=                                                                      @@+++++++@@                           
           @@++++++@@                                     %@=++++++++++**%@@@@@@@@@@@@@@#+-.            @@++++++*@@                              
              @@++++++@@                               @@=====++++++++++++++++++++++++++++++++++++++++#++++++%@-                                 
                 @@++++++@@                     .: .@@=======@@@@@@@@@@@@%#*++++++++++++++++++++++++++#+++@@.                                    
                    @@*+++++@@.              %  -@=======@@:                        .:*@@@@@@@@@@@@%#**@@                                        
                       +@*+++++@@.           .@=======@@                                                                                         
                          :@%+++++%@-     .@====#====@                                                                                           
                             .@@+++++*@#@============@                                                                                           
                                 @@++++@======*======@                                                                                           
                                    @@+@===%===*=====@                                                                                           
                                       @===+=====%===@                                                                                           
                                       @====+%===+===@                                                                                           
                                       @====#=@==*===@                                                                                           
