                                                                                            @@.                                                  
                                                                         @@              @@.                                                     
                                                                        @=@              @@@.                                                    
                                                                      @@=@@              @+++%@-                                                 
                                                                     @%==%@              +#+++++*@@                                              
                                                                   @==%=*=@               @@++++++++@@                                           
                                                                .@=+=%==@+ :@*               %@#+++++++@@                                        
                                                     @-   .+=+*===@=+@+       .@@               .@@+++++++%@-                                    
                                                    @=*==%=@*==*=+@=              @@                @@*++++++*@@                                 
                                                    @=@=%@=+==*@-                    @@                -@%+++++++@@                              
                                                    #=#====*@:                          @@                 @@+++++++@@                           
                                                    .*==*@:                                @@.                %@*++++++%@-                       
                                                     #@.                                      *@:                .@@++++++*@@                    
                                                     @                                           -@*                 @@+++++++@@                 
                    @@#%-                            @                                              .@@                 =@%++++++@@.             
                  @##@###.                           -*                                                 @@                  @@++++++%@-          
                 =###@###@                            @                                                    @@                  @@*+++++*@@       
                 @###@####                            @                                                       @@                  .@@++++++@@    
                -####@####                            #-                                                         @@.                  @@++++++@@ 
                @####@####                             @                                                            #@.                  +@%+++++
                @####%####                             @                                                               -@=                   @@++
                @#########                             @.                                                                 .@@                   @
                @#########.                             @                                                                     @@                 
                @#########.                             @                                                                        @@              
                %######@@. @@                           @                                                                          .@=           
                ####@@        @@             .          @@                                                                      -@%+*@           
                -@@              @@.@=*==@====@@=#@@@@@                                                                      %@*+++++@           
                @@@.                #@+=*=*==@*#==@%                                                                      @@+++++++@@            
                @+++%@-                :@%%+==%@-                                                                      @@++++++*@@               
                @@+++++*@*                .@@.                                                                     .@@++++++%@-                  
                   @@+++++*@@                                      @@=*++++++*#%@@@@@@@@@@@@@@*:.               +@#++++++@@.                     
                      @@++++++@@                               :@@====@++++++++++++++++++++++++++++++++++++**%@*++++++@@                         
                         @@++++++@@                      #  @@+======@@@@@@@@@@%#++++++++++++++++++++++++++++++*+++@@                            
                            #@*+++++@@                +  @%=======@@                      .-*@@@@@@@@@@@@%**+++#@#                               
                               +@*+++++@@.          . @*=%====+@@                                                                                
                                  :@%+++++%@:      @*====@===@                                                                                   
                                     .@@+++++*@+@+==*%===@===@                                                                                   
                                         @@++++@====#==@=%===@                                                                                   
                                            @@+@====@===@%===@                                                                                   
                                               @====@====#+==@                                                                                   
                                               *+===*=+==*===@                                                                                   
                                               -#===+==*=+===@                                                                                   
                                                @=======+====@                                                                                   
                                                @====*===+===@                                                                                   
