                                                                                       @+==+@              @*++++++@@                            
                                                                                     %====%=@               @@*+++++++@@.                        
                                                                                  @%*==+=@@   @@               :@@+++++++%@-                     
                                                                      =@=   #=@=%@==+=@@         @@                @@+++++++*@@                  
                                                                      @+===@=@#=+==@@               @@                #@#+++++++@@               
                                                                      @=#=*+=%==@@                     @@.               .@@+++++++@@.           
                                                                      @===@==@@                           #@:                @@*++++++%@-        
                                                                      -%==@@                                 -@+                :@@++++++*@@     
                                                                       @@                                       .@@                 @@+++++++@@  
                                                                       @                                           .@@                 %@#++++++@
                                     .@@###                            @                                               @@                 .@@++++
                                    @##@###.                           ++                                                 @@                  @@*
                                   @###@###@                            @                                                    @@.                 
                                   %###@####                            @                                                       #@.              
                                  %####@####                            @.                                                         =@=           
                                  @####@####                             @                                                            .@#        
                                  @####@####                             @                                                                @@     
                                  @####%####                             @.                                                                  @@  
                                  @#########.                            .@                                                                     @
                                  @#########.                             @                                                                      
                                  @######@@  @@                           @                                                                      
                                  @###@@        @@.     .  +   *         .@-                                                                     
                                  *@*              +@-@=@==@====@@=@@*@@+                                                                      @@
                                  @*@+                .@%=@=%==+##=@@.                                                                     .@@+++
                                  @+++*@@                 @@*===@@                                                                      =@#++++++
                                  @@++++++@@                 @@                                                                      @@*++++++@@ 
                                     @@++++++@@                                     =@#=*++++++++**#@@@@@@@@@@@@@@%*=..           @@+++++++@@    
                                        #@*+++++@@                               @@=====%++++++++++++++++++++++++++++++++++++++++++++++*@#       
                                           =@#+++++@@                      #  @@=======@@@@@@@@@@@@@#*++++++++++++++++++++++++++++++%@:          
                                              :@%+++++@@.              =. .@=======*@#                        ..+%@@@@@@@@@@@@#*+@@.             
                                                 .@@+++++#@=            @==*====@@.                                                              
                                                    .@@+++++*@#      @====+#===@                                                                 
                                                        @@++++++@@@====*===%===@                                                                 
                                                           @@++++@====+====@===@                                                                 
                                                              @@+@===@#====@===@                                                                 
                                                                 @====@====@===@                                                                 
                                                                 @====%@===%===@                                                                 
                                                                 **===*=#==#===@                                                                 
                                                                 :%===+===@*===@                                                                 
                                                                 .@====#===@===@                                                                 
                                                                  @=====*==+==   @@                                                              
                                                                  @=======:         @@                                                           
                                                                  @====.               %@                                                        
                                                                  @+                +@#+@                                                        
