                                                                                        .@@                                   @@==*=%====#==%=@@.
                                                                                     .@@                                         *@+=%*=@=+@@    
                                                                                  .@%                                               -@#+@@       
                                                                               .@*                                                               
                                                             @*              @+                                                                  
                                                            @*=              +#%@-                                                               
                                                         :%%*+=              .@+++*@@                                                            
                                                        :@=*+@=               @+++++++@@                                                         
                                                       @*@%===@@               @@*+++++++@@.                                                     
                                                .   #=@=+==@@    @@               .@@+++++++%@-                                                  
                                        @*@  .@=*==*=%==@@          @@                @@+++++++*@@                                               
                                        @@*==+====@==@@                @@                +@#+++++++@@                                            
                                        :===*==%==@@                      @@.                @@+++++++@@.                                        
                                         %==*=+@@                            @@.                @@*++++++%@-                                     
                                         #==@@                                  =@=                :@@++++++*@@                                  
                                         @@                                        .@%                 @@+++++++@@                               
                                         @                                            .@@                 #@#++++++@@.                           
       :%@##@                            :%                                               @@                 .@@++++++%@-                        
      @##@###@                            @                                                  @@                  @@*+++++*@@                     
     .###%####                            @                                                     @@                  :@@++++++@@                 +
     @#########                           ++                                                       @@.                  @@++++++@@           @@+#
     #########%                            @                                                          +@-                  %@#+++++%@-    @@+++++
    %#########%                            @                                                             :@%                   @@+++++*@@++++++*+
    *#########%                            %.                                                               .@@                   @@*+++++++@@.#*
    =#########@                             @                                                                   @@                   -@@@@+    **
    .#####%###@                             @                                                                      @@                          +*
    .#####@###@                             @.                                                                        @@                       =#
     #####@@#   @@                           @                                                                         @@@                     =#
     ##%@-         @@.    .@ .@--@   .     *@-                                                                      @@+++@                     =%
    #@.               +@@++@==%===@=*@#=@@.                                                                     :@@++++++@                     -%
    @+#@+                .@@=%=@@=*=*@@                                                                      @@*++++++@@                       :@
    @++++*@%                 @@==+@@                                                                      @@+++++++@@                          .@
     @@++++++@@                 .                        *@@%*=..                                      @@++++++*@@                              @
        @@++++++@@                                    @@==@+++++++++++++++*##@@@@@@@@@@@@@@@+:.    .@@++++++#@=                                 @
           @@*+++++@@                              @@=====@++++++++++++++++++++++++++++++++++++++++@+++++@@.                                     
              +@*+++++@@.               .   := :@=======*@# ..+@@@@@@@@@@@@@#*+++++++++++++++++++++@++@@                                         
                 :@%+++++%@:            *#  :@=======@@.                               -+@@@@@@@@@@@@                                            
                    .@@+++++#@=         @-@==+====@@                                                                                             
                       .@@+++++*@@    -@%===@====@.                                                                                              
                           @@++++++@@===#========@.                                                                                              
                              @@+++#*===+=%======@.                                                                                              
                                 @@*%======@=====@.                                                                                              
                                    @========+===@.                                                                                              
                                    @====+=======@.                                                                                              
