                                                                                        @@.                                .@@+%=%==@=%==@=@@=@@ 
                                                                                     @@                                        @@#=@=%==#=+@*    
                                                                                  @@                                              @@===@@.       
                                                                               @@.                                                   @           
                                                            @@              @@                                                                   
                                                           @+@              @@@                                                                  
                                                         @@=#@              @+++@@.                                                              
                                                        #%==@@              @++++++%@-                                                           
                                                      @==*=%=@              .@@+++++++*@@                                                        
                                                   -@===@=*@- %@.               @@++++++++@@                                                     
                                        @    =+*+=++=@=*@:       =@-               =@%+++++++@@                                                  
                                       *=+==%==%==+=#@.             .@#                @@+++++++%@-                                              
                                       @=@=#%===*%@.                    @@                @@*++++++*@@                                           
                                       @=+++%=%@.                          @@                .@@+++++++@@                                        
                                       @%==@@.                                @@                 @@+++++++@@.                                    
                                       .@@                                       @@                 +@%++++++%@-                                 
                                        @                                           @@.                 @@++++++*@@                              
       @@#@                             @                                              *@-                 @@*++++++@@                           
     @##@##%                            @.                                                :@*                 :@@++++++@@                        
    @###@###@                           .@                                                   .@@                  @@++++++%@-                  ..
    ####@###@                            @                                                      .@@                  *@#+++++*@@            #@*@ 
   @####@###@                            @                                                          @@                   @@++++++@@      +@*++++@
   @####@###@                            .@                                                            @@                   @@*+++++@@+@*++++++++
   @####@###%                             @                                                               @@.                  :@@++++@++++*@@@++
   @####@####                             @                                                                  *@:                   @@+@+@@.   @++
   @####@####                             ++                                                                    -@+                   :       @++
   @####%####                              @                                                                       .@@                        @++
   @######@@.:@*                           @                                                                          :@                      @++
   @###@@       .@@         .              @.                                                                      #@*+%:                     @++
   @@@              @@ @*==#@=#=%@+=-@@:@@                                                                      @@+++++*%                     @++
   @@@                 @@===*=*=@%%=*@*                                                                      @@+++++++@@                      @++
   @+++@@                 #@==%==@@.                                                                     .@@++++++#@+                         @++
   @@+++++@@.                -@@                                                                      -@%++++++@@.                            @++
     .@@+++++#@-                                      @@-+++++**#@@@@@@@@@@@@@@%*=.                %@*++++++@@                                @++
         @@+++++*@%                               =@#====*++++++++++++++++++++++++++++++++++++##%@+++++++@@                                     @
            @@++++++@@                      +  @@=======@@@@@@@@@%#*+++++++++++++++++++++++++++++*+++*@@                                         
               @@++++++@@               .-  @*=======@@                     .:*@@@@@@@@@@@@%#*+++*#@+                                            
                  @@++++++@@             @=======*@+                                                                                             
                     @@*+++++@@       @=====*===@                                                                                                
                        *@*+++++@@.@====@===+===@                                                                                                
                           -@#++++@=======#=*===@                                                                                                
                              .@%+@===++===@*===@                                                                                                
                                 .@====@====%===@                                                                                                
                                  @====%+===@===@                                                                                                
